afryka|środowiskowo: bieda, głód, ubóstwo
aktualności|aktualne wydarzenia lub informacje o nich aktualia (rzadziej)
akwarium|zbiornik na wodę, zwykle szklany, przeznaczony do hodowli roślin, ryb i in. organizmów wodnych bywa wyposażone w urządzenia utrzymujące określone warunki środowiska wodnego
aladyn|bohater "Księgi tysiąca i jednej nocy", który wszedł w posiadanie magicznej lampy, zamieszkiwanej przez dżina spełniającego wszystkie życzenia jej posiadacza
alfabet|zestaw liter, czyli symboli graficznych dźwięków danego języka, ułożony w porządku tradycyjnym abecadło|zbiór znaków jakiegoś systemu znakowego, odpowiadających literom alfabetu
altówka|instrument smyczkowy o 4 strunach, strojony o kwintę niżej od skrzypiec viola wiola
amazonka|kobieta jeżdżąca konno|damski strój do konnej jazdy
ameryka|część świata składająca się z 2 kontynentów: Ameryki Północnej i Ameryki Południowej|pot. USA
amorek|wyobrażenie w sztuce rzymskiego bożka miłości amor|motyw dekoracyjny, postać nagiego chłopczyka ze skrzydłami kupidyn kupido putto
anioł|osoba nadprzyrodzona pośrednicząca pomiędzy Bogiem a ludźmi, uosabiająca dobroć i doskonałość|przenośnie: osoba bardzo dobra, szlachetna, łagodna
antena|urządzenie stanowiące element każdego nadajnika lub odbiornika, wysyłające albo odbierające fale radiowe
arachid|fistaszek, orzeszek ziemny, orzeszek arachidowy|a) owoc orzecha ziemnego zawierający jadalne nasiona|b) jadalne nasiono owocu orzecha ziemnego
arkada|forma łuku wspartego na dwóch kolumnach lub filarach
armata|działo o długiej lufie i prostym torze lotu pocisku
armia|ogół sił zbrojnych danego państwa wojsko|najwyższa jednostka operacyjna składająca się z kilku korpusów lub dywizji
artysta|człowiek uzdolniony, tworzący dzieła (np. malarz), kreujący jakąś rolę (aktor) lub wykonawca utworu muzycznego (np. piosenkarz)|ktoś najlepszy w swoim fachu arcymistrz
as|najstarsza karta w większości gier karcianych|ktoś perfekcyjny w tym co robi, mistrz
asteroida|w astronomii: ciało niebieskie niewielkich rozmiarów poruszające się dookoła Słońca, głównie między orbitami Marsa i Jowisza planetoida|w geometrii: krzywa w kształcie gwiazdy czteroramiennej
atak|natarcie, uderzenie na przeciwnika|nagłe pojawienie się objawów choroby
atrament|barwny roztwór o różnorodnym składzie chemicznym, służący do pisania przy użyciu pióra, lub drukowania
atut|atu wybrany przez graczy kolor kart bijący pozostałe kolory także: karta w tym kolorze|możliwość, której odpowiednie wykorzystanie prowadzi do sukcesu szansa powodzenia
aureola|w sztuce: świetlisty krąg nad głową świętego|świetność, chwał, splendor
autobus|duży pojazd przeznaczony do przewożenia kilkudziesięciu osób, służący do komunikacji miejskiej lub międzymiastowej
awatar|personifikacja jakiegoś bóstwa lub osoby w odmiennym świecie
awokado|avocado|wiecznie zielone drzewo z rodziny wawrzynowatych, uprawiane w strefie międzyzwrotnikowej dla smacznych owoców smaczliwka|owoc tego drzewa, o gruszkowatym kształcie, do 20 cm długości, ciemnozielonej skórce, tłustym miąższu i dużej pestce gruszka awokado
azja|część świata tworząca wraz z Europą kontynent zwany Eurazją
babcia|pieszczotliwie o matce ojca lub matki|starsza kobieta staruszka
babeczka|zdrobnienie od: babka (ciastko)|pieszczotliwie o babce (młodej kobiecie)
bagaż|rzeczy zapakowane do przewozu
bakłażan|roślina jednoroczna warzywna z rodziny psiankowatych, dorastająca do 1 m wysokości oberżyna, psianka podłużna, gruszka miłosna, jajko krzewiaste
balkon|płyta na zewnątrz budynku połączona z pomieszczeniem wewnętrznym otoczona balustradą
balon|statek powietrzny poruszający się razem z wiatrem, składający się z powłoki wypełnionej gazem oraz gondoli|zabawka dla dzieci wykonana z gumy lub tworzywa sztucznego, napełniana najczęściej powietrzem lub helem
bambus|drewniejąca bylina z rodziny wiechlinowatych (traw) źdźbła do 30 cm średnicy rośnie bardzo szybko, do 1 m na dobę
banan|owoc tropikalny
bandyta|zbir, człowiek żyjący z bandytyzmu
basen|sztuczny zbiornik na wodę staw, sadzawka|teren, na którym znajduje się ten zbiornik kąpielisko, pływalnia
bateria|ogniwo elektrochemiczne lub zespół takich ogniw w jednej obudowie, będący przenośnym źródłem prądu, np. w latarkach, telefonach|zespół podobnych urządzeń technicznych połączonych i współpracujących ze sobą w jednym układzie
bawół|ssak, podobny do krowy, o dużych krętych rogach, żyjący w stanie dzikim
baza|podstawa czegoś
bazgrać|pisać niestarannie, niewyraźnie nieudolnie rysować, malować, bazgrolić
bałwan|spieniona fala morska|wypchany cietrzew lub jego podobizna
bańka|blaszane naczynie do przechowywania i przenoszenia płynów|mała, szklana kulka używana w celu wywołania miejscowego przekrwawienia
beczka|duże naczynie w kształcie walca o wypukłych ściankach, wykonywane często z drewnianych klepek ujętych blaszanymi obręczami
beknięcie|rzadko: brzydko, fałszywie zaśpiewać
bezdomny|nie mający domu, miejsca zamieszkania
bezprzewodowy|niemający przewodu
bezsenność|zaburzenie snu charakteryzujące się utrudnionym zasypianiem lub trwałym, przedwczesnym budzeniem się
biały|taki jak świeży śnieg przeciwstawny do czarnego
biblioteka|instytucja gromadząca i udostępniająca książki, wydawnictwa|księgozbiór, zwł. uporządkowany
biedronka|drobny chrząszcz, zwykle czerwony w czarne kropki
bila|kula do gry w bilarda|w bilardzie: uderzenie kulą o kulę
bilet|kartka z odpowiednim nadrukiem wydającej ją instytucji, będąca dowodem uiszczenia opłaty przez nabywcę, uprawniająca do określonej usługi|kartka z krótką wiadomością, liścik, dziś tylko w wyrażeniu: bilet wizytowy
bileter|pracownik mający za zadanie kontrolę ważności biletów, np. w kinie
biurko|mebel służący do pracy biurowej lub nauki
blizna|ślad pozostały po zagojeniu się rany znamię
bliźnięta|jeden z dwojga osobników urodzonych w czasie jednego porodu bliźniak
blond|tylko w odniesieniu do włosów: jasny, złotawy, płowy
bocian|duży ptak należący do rodzaju brodzących, częsty w Polsce
boczek|zdrobnienie od bok|rodzaj mięsa wieprzowego, część tuszy wieprzowej
boisko|plac przeznaczony do rozgrywania pojedynków sportowych, np. meczów piłki nożnej|regionalnie: centralna część stodoły klepisko
boks|walka na pięści pięściarstwo|wydzielona część większego pomieszczenia
bomba|rodzaj pocisku z mechanizmem zapłonowym|przenośnie: coś efektownego sensacyjna wiadomość
brama|zamknięcie otworu wejściowego lub wjazdowego do budynku, posesji itp. sam ten otwór|przejście prowadzące w obręb twierdzy wraz z murowanym obudowaniem obronnym
bramkarz|zawodnik broniący bramki w wielu sportach drużynowych, czasem posiadający pewne przywileje w stosunku do pozostałych zawodników golkiper|potocznie: ochroniarz w klubie, dyskotece, stojący przy wejściu
bransoletka|ozdoba w kształcie małej obręczy|potocznie: kajdanki
brazylia|Federacyjna Republika Brazylii państwo w Ameryce Południowej|miasto, stolica państwa Brazylia
broda|wystająca część twarzy poniżej ust|zarost poniżej ust, na podbródku i na szczękach
brodawka|narośl na skórze|zgrubienie na roślinach lub owocach
brokuły|potrawa z jadalnych kwiatostanów i łodyg brokułu
brud|zanieczyszczenie, brak czystości
brzoskwinia|drzewo owocowe z rodziny różowatych, o liściach lancetowatych, kwiatach różowych rozwijających się przed ulistnieniem i o omszonych, żółtych z czerwonym rumieńcem owocach, pochodzące z Chin brzoskwinia zwyczajna|owoc tego drzewa
brzoskwinie|drzewo owocowe z rodziny różowatych, o liściach lancetowatych, kwiatach różowych rozwijających się przed ulistnieniem i o omszonych, żółtych z czerwonym rumieńcem owocach, pochodzące z Chin brzoskwinia zwyczajna|owoc tego drzewa
brzuch|część tułowia człowieka i wyższych zwierząt, ograniczona kośćmi miednicy i przeponą
brzytwa|ostre narzędzie, zwykle składane, służące do golenia|przenośnie: człowiek surowy, stanowczy, wymagający
bucik|zdrobnienie od: but mały but butek
budynek|obiekt budowlany, który jest trwale związany z gruntem, wydzielony z przestrzeni za pomocą przegród, posiadający fundamenty i dach
burza|intensywne opady deszczu lub deszczu i gradu, któremu towarzyszą wyładowania elektryczne
butelka|szklane naczynie z wydłużoną szyjką do przechowywania płynów zawartość tego naczynia
buty|pycha, wyniosłość
bułeczka|zdrobnienie od: bułka
byk|samiec bydła domowego dorosły samiec wielkich przeżuwaczy (np. jaka)|pot. o osobie silnie zbudowanej
ból|cierpienie fizyczne lub psychiczne
bączek|mały bąk|najmniejszy ptak z rodziny czaplowatych
bęben|perkusyjny instrument muzyczny|cylindryczna lub wieloboczna podstawa kopuły
bębny|perkusyjny instrument muzyczny|cylindryczna lub wieloboczna podstawa kopuły
błazen|artysta cyrkowy występujący w roli komicznej|człowiek ośmieszający się
błoto|rozmokła ziemia tworząca gęstą, lepką masę
błyszczka|przynęta imitującą rybę do łowienia na wędkę ryb drapieżnych błyszczyk błystka błyszcz błysk
cebula|roślina warzywna o ostrym smaku i zapachu
cegła|materiał budowlany|kawałek jakiejś masy mający kształt prostopadłościanu
cel|coś do czego się dąży|obiekt ostrzału
centrum|środkowa część czegoś |miejsce, w którym coś się koncentruje
chanuka|radosne święto żydowskie upamiętniające oczyszczenie Świątyni Jerozolimskiej przez Judę Machabeusza z bezczeszczących ją posągów, obchodzone przez 8 dni od 25 dnia hebr. miesiąca kislew Hanukka, Święto Poświęcenia Świątyni, Święto Świateł
chata|drewniany budynek na wsi lub w górach
chiny|wiecznie zielone drzewo i krzew z rodziny marzanowatych, rosnące w Andach, hodowane na Jawie i w Indiach drzewo chinowe, chinowiec|kora drzewa chinowego, z której wytwarza się środek przeciwgorączkowy i przeciwmalaryczny kora chinowa
chirurg|lekarz będący specjalistą w dziedzinie chirurgii
chleb|pieczywo z mąki i wody na drożdżach lub na zakwasie, formowane w bochenki bochenek takiego pieczywa|przen.|a) byt, utrzymanie, zarobek, praca|b) rzad. zboże
chmiel|a) ludowa obrzędowa pieśń weselna śpiewana przy oczepinach|b) muzyka do tej pieśni|c) taniec do tej pieśni taniec chmielowy
chmura|kropelki wody, kryształki lodu albo ich mieszanina, skupione i zawieszone w atmosferze|wielka ilość lub liczba czegoś
chodnik|miejsce przeznaczone dla ruchu pieszego trotuar|wąski dywanik podłogowy
chomik|gryzoń niewielkich rozmiarów z rodziny chomikowatych|żartobliwie o człowieku namiętnie gromadzącym zapasy
choroba|każdy stan zakłócający normalne funkcjonowanie organizmu lub jego części|negatywne zjawisko albo czyjaś wada
chrapać|wydawać charkotliwe, świszczące dźwięki podczas snu pochrapywać|potocznie: spać drzemać, kimać
chrupać|wydawać charakterystyczny odgłos przy łamaniu, gryzieniu, kruszeniu czegoś|gryźć coś twardego, kruchego
chudy|mający (zbyt) mało ciała bardzo szczupły|mający mało tłuszczu, nietłusty
chwast|wiązka nici, wełny, kordonków zdobiąca brzegi tkanin
ciasteczka|zdrobnienie od: ciastko
ciastko|wyrób cukierniczy m.in. z mąki, wody i jaj
ciasto|gęsta masa z mąki, wody, jaj i innych składników|wypiek z takiej masy
cichy|wydający słabo słyszalne dźwięki lub nie wydający ich wcale|spokojny, wycofany
ciekły|mający właściwości cieczy cieknący, płynny
cielę|małe, młode przeżuwaczy, np. krowy, łani|przen. pot. osoba głupawa, nieenergiczna itp.
cienki|płaski, wąski|wysoki, piskliwy
ciepło|temperatura między zimnem a gorącem|atmosfera serdeczności
cierń|twardy, ostro zakończony wyrostek roślinny, chroniący roślinę przed zjedzeniem kolec|coś sprawiającego przykrość
cień|obszar, do którego nie dociera światło|przenośnie: śladowa ilość czegoś resztka, pozostałość
ciągnik|pojazd mechaniczny o dużej sile pociągowej, napędzany silnikiem spalinowym traktor|część wrębiarki górniczej
ciąć|uderzyć (uderzać) czymś ostrym, raniącym ciało smagnąć (smagać), rąbnąć (rąbać)|o niektórych owadach: ukłuć (kłuć), ukąsić (kąsać)
cmentarz|miejsce pochówku zmarłych
cud|niezwykłe, niecodzienne zjawisko lub coś bardzo pięknego, niesamowitego
cukier|produkt spożywczy wytwarzany z trzciny cukrowej lub buraków cukrowych
cukierek|przysmak z cukru
cygaro|suche, zawinięte w rulon liście tytoniu, przeznaczone do palenia
cyklop| olbrzym z jednym okiem umieszczonym po środku czoła
cyrk|namiot lub budynek z areną, na której odbywają się występy prestidigitatorów, klaunów, akrobatów, tresowanych zwierząt itp.|widowisko cyrkowe
cytrynowy|dotyczący cytryny (drzewa lub krzewu) np. gaj cytrynowy|zrobiony z owoców cytryny, mający smak cytryn, zapach cytryn
cytryny|roślina z rodziny rutowatych, niewysokie drzewo lub krzew o wiecznie zielonych liściach, białych kwiatach i żółtych owocach cytrynowiec, drzewo cytrynowe|owoc rośliny o tej samej nazwie, mięsisty, o soczystym, kwaśnym miąższu i żółtej skórce
czajniczek|zdrobnienie od: czajnik
czarny|ciemny|mroczny, nie oświetlony
czarodziej|człowiek zajmujący się magią, czarami czarnoksiężnik mag magik czarownik
czarownica|kobieta zajmująca się czarami czarodziejka
czas|w filozofii i fizyce: wielkość pozwalająca określić kolejność zdarzeń i porównywać odstępy między nimi|w teorii względności: jeden z wymiarów czasoprzestrzeni
czasopismo|pismo okresowe wydawane w stałych terminach|egzemplarz takiego pisma
czek|rodzaj przekazu pieniężnego
czerwony|mający kolor krwi|komunistyczny, lewicowy
czosnek|dwuletnia, cebulkowa roślina warzywna, używana jako przyprawa kuchenna oraz środek leczniczy
czołg|rodzaj silnie uzbrojonego i opancerzonego wozu bojowego na zawieszeniu gąsienicowym, przystosowanego do poruszania się w trudnym terenie
czoło|część twarzy człowieka nad brwiami i nosem|część przednia czegoś przód, front, fasada
czółenko|małe czółno|pantofel damski
dach|konstrukcja chroniąca budynek przed opadami atmosferycznymi|górna część pojazdu
dama|figura w kartach|wytworna, poważana kobieta
delfin|dawniej: następca tronu francuskiego|żartobliwie: syn pierworodny
dentysta|lekarz specjalizujący się w zakresie dentystyki (stomatologii) stomatolog
deszcz|opad atmosferyczny spadający z chmur w formie kropel
diabeł|zły duch, wyobrażany jako istota z rogami, ogonem i kopytami szatan, czart, bies|potocznie: ktoś zły, niebezpieczny, nieznośny
diament|polimorficzna odmiana pierwiastka węgla, najtwardszy minerał występujący w przyrodzie|przyrząd służący do rżnięcia szkła i szlifowania drogich kamieni
dinozaur|[czytaj: diNOzałr]|przedstawiciel wymarłej grupy gadów znanych od późnego triasu do końca ery mezozoicznej|przenośnie: osoba żyjąca bardzo długo lub zajmująca się czymś do późnych lat
diwa|diva|przestarzałe: słynna śpiewaczka operowa lub operetkowa primadonna|słynna artystka, np. aktorka gwiazda
dobrze|zgodny z zasadami moralnymi|skłonny do pomocy
dodaj|zwiększyć ilość czegoś
dok|miejsce w porcie do załadowywania i rozładowywania statków|basen stoczniowy do budowy i remontu statków
dolar|jednostka monetarna USA oraz wielu innych krajów|jednostka miary reaktywności reaktora jądrowego
dolina|dawniej: kieszeń|podłużne wgłębienie na powierzchni ziemi powstałe wskutek erozji wody płynącej
dolny|znajdujący się na niskiej wysokości, u dołu, niżej położony
dom|mieszkanie|budynek
dowód|coś dowodzące czegoś, świadczące o czymś lub zaświadczające coś
dołeczki|zdrobnienie od: dołek
drenaż|system osuszania gruntów za pomocą układanych pod ziemią drenów
drewno|złożona tkanka roślinna roślin naczyniowych, zajmująca przestrzeń między rdzeniem, a kambium
droga|pas ziemi służący do komunikacji|jakiś szlak komunikacyjny tor, linia
drut|cienki pręt metalowy|przewód telefoniczny
dryblować|prowadzić piłkę (w piłce nożnej) lub krążek (w hokeju) blisko siebie lekkimi pchnięciami i częstą zmianą kierunku dla zmylenia przeciwnika driblować
drzazga|maleńki kawałek jakiegoś materiału, który się wbił w (pod) skórę zadra
drzewo|duża roślina o zdrewniałej łodydze w postaci pnia|materiał uzyskany ze ściętego drzewa (bez kory i gałęzi) drewno
drzwi|pionowa ruchoma przegroda zamykająca otwór drzwiowy wraz z konstrukcją mocującą oraz wszystkimi elementami pomocniczymi
duch|całokształt właściwości osobniczych, posiadanych przez człowieka w zakresie osobowości, temperamentu, emocji itd. psyche, psychika, umysł, świadomość, dusza|w niektórych systemach filozoficznych: niematerialny składnik rzeczywistości, byt osobowy o atrybutach sprawczych
dudy|osoba grająca na dudach dudziarz dudarz
duszek|postać baśniowa, maleńka istota o cechach nadprzyrodzonych|zdrobnienie od: duch
dwór|obszerny dom w posiadłości ziemskiej|majątek ziemski, folwark jego właściciele i mieszkańcy
dynamit|kruszący materiał wybuchowy
dynia|roślina warzywna owoc tej rośliny
dyplom|dokument świadczący o kwalifikacjach|wyróżnienie
dyrektor|osoba zarządzająca i odpowiadająca za prowadzony przez siebie zakład administracyjny lub inną jednostkę strukturalną
dyskoteka|płytoteka|zabawa dla młodzieży
dywan|gruba tkanina ozdobna przykrywająca podłogę|dawniej: urząd dworski w krajach muzułmańskich
dzban|naczynie użytkowe lub dekoracyjne zwykle zwężone u góry z jednym uchem (niekiedy z dwoma) zawartość tego naczynia
dzbanek|zdrobnienie od: dzban
dziadek|ojciec matki albo ojca|staruszek
dzieci|człowiek od narodzin do okresu dojrzewania|potomek ludzki niezależnie od wieku, syn albo córka
dziecko|człowiek od narodzin do okresu dojrzewania|potomek ludzki niezależnie od wieku, syn albo córka
dziewczyna|młoda, niezamężna kobieta narzeczona, sympatia
dziwne|osobliwy, niezrozumiały
dziób|wydłużona, przednia część głowy ptaków obejmująca otwór gębowy|potocznie: twarz, zwłaszcza usta, wargi
dzwon|instrument odlany z metalu, pusty w środku, o kształcie kielicha|dźwięk wydawany przez dzwon dzwonienie
dzwonek|przyrząd wydający brzęczący dźwięk, używany do sygnalizacji|dźwięk dzwonka dzwonienie
dąb|drzewo z rodziny bukowatych występujące w kilku gatunkach * forma dopełniacza l.poj. "dęba" możliwa tylko w wyrażeniach:|"stanąć dęba":|a) o włosach: najeżyć się (np. ze strachu)|b) o człowieku: stanąć na rękach lub na głowie także: zbuntować się|c) o koniu: stanąć na tylnych nogach|potoczne: "dać dęba" - uciec
długie|odznaczający się ponadprzeciętną odległością pomiędzy skrajnymi punktami, ciągnący się na znaczną odległość|mierzący wzdłuż, często w połączeniu z jednostkami liczbowymi (np. pomieszczenie długie na 7 metrów)
dźwig|maszyna służąca do przenoszenia ciężkich ładunków, zazwyczaj na budowie|winda
dźwiękowy|przymiotnik od: dźwięk
dżem|rodzaj konfitur o galaretowatej konsystencji przyrządzany przez gotowanie świeżych owoców z dodatkiem cukru i pektyny jam (przestarzałe)
dżinsy|spodnie z dżinsu jeansy
dżungla|gęsty, wilgotny, wiecznie zielony las tropikalny|przenośnie:|a) coś bardzo skomplikowanego, zagmatwanego|b) miejsce, gdzie występuje bezwzględna walka o wpływy, gdzie liczy się tylko prawo silniejszego
ekran|płaszczyzna, na którą rzutuje się obrazy świetlne, np. ekran kinowy, projekcyjny|powierzchnia, na której powstaje obraz lub zapis w wyniku luminescencji, np. ekran telewizyjny, radaru
eksplodować|książkowo:|wybuchnąć, wybuchać, rozpaść się, rozpadać się na drobne kawałki z hukiem|przenośnie: gwałtownie dać, dawać ujście swoim emocjom wybuchnąć, wybuchać
eskimos|przedstawiciel rdzennej ludności zamieszkującej obszary Grenlandii, Kanady, Alaski i Syberii Innuita, Inuita
etap|część przebywanej drogi, odległość między dwoma postojami|okres rozwoju stadium procesu faza
europa|[czytaj: ełropa] środowiskowo: szklane opakowanie o pojemności 0,5 litra, w kształcie butelek, przystosowane do przechowywania napojów, głównie piwa
fabryka|zakład przemysłowy wytwarzający maszynowo na wielką skalę środki spożycia i produkcji
fala|wzniesienie wody powstałe głównie wskutek działania wiatru|rozchodzące się w przestrzeni zaburzenie, przenoszące energię
fale|wzniesienie wody powstałe głównie wskutek działania wiatru|rozchodzące się w przestrzeni zaburzenie, przenoszące energię
falowanie|poruszać się wznosząc fale powodować fale
fani|zagorzały zwolennik czegoś
farba|mieszanina barwników używana do malowania|krew rannej, grubej zwierzyny jucha posoka
faul|naruszenie przepisów gry, np. przez niedozwolony chwyt przeszkadzający przeciwnikowi w grze foul (rzadko)
feniks|palma tropikalna|symbol odrodzenia się z upadku, ruiny
finlandia|państwo w Europie ze stolicą w Helsinkach Republika Finlandii|marka wódki
flaga|tkanina o określonych barwach i kształtach umocowana do drzewca chorągiew bandera
flaming|duży ptak o długim dziobie zgiętym w połowie ku dołowi, wysokich nogach, długiej szyi oraz białym upierzeniu z różowym nalotem czerwonak
flinta|myśliwska strzelba na śrut fuzja
floryda|półwysep w Stanach Zjednoczonych|stan w Stanach Zjednoczonych
foka|ssak wodny
fontanna|urządzenie składające się ze zbiornika (w formie basenu, czaszy lub misy) i trzonu z dyszą, z której tryska woda doprowadzona pod ciśnieniem wodotrysk
fortepian|instrument klawiszowy
frajerem|człowiek naiwny, łatwo dający się oszukać
frakcja|wyodrębniona część większej całości|odłam w ramach ugrupowania politycznego
francja|państwo w Europie ze stolicą w Paryżu Republika Francuska
frytki|zwykle w l. mnogiej: kartofle krajane w paseczki, smażone w dużej ilości tłuszczu frytek
fryzjer|człowiek zajmujący się zawodowo strzyżeniem, goleniem, czesaniem
futro|sierść pokrywająca skórę wielu ssaków|skóra wraz z sierścią
gabinet|lokal przeznaczony do wykonywania specjalistycznego zawodu|sala przeznaczona do wystawiania np. okazów
gad|kręgowiec lądowy oddychający płucami, o skórze pokrytej łuskami, płytkami lub tarczkami|przen. o podłym człowieku
galaktyka|układ gwiazd i materii międzygwiezdnej wiązany siłą grawitacji, obracający się wokół centrum
galaretka|zdrobniale galareta
garaż|pomieszczenie do przechowywania samochodów
gardło|odcinek przewodu pokarmowego i oddechowego, który znajduje się między jamą ustną a przełykiem gardziel|utrata życia przez powieszenie lub ścięcie
garnek|naczynie wykonane z metalu lub gliny służące do gotowania pożywienia
gaz|ciało lotne, jeden z trzech stanów skupienia materii
gałązka|nazwisko
gałęzie|pęd wyrastający z pnia drzewa konar, odrośl|urzędowo: dział nauki, gospodarki itp.
gitara|sześcio-, rzadziej siedmiostrunowy instrument muzyczny szarpany|dźwignia w obrabiarce do gwintów i uzębień służąca do osadzania osi kół zmianowych
gleba|powierzchnia litosfery, składa się z 4 części: mineralnych, organicznych, powietrza i wody|potocznie: upadek
glina|skała osadowa wykorzystywana w garncarstwie, budownictwie, rzeźbiarstwie itp. dzięki swoim plastycznym właściwościom występującym w pewnych warunkach|pogardliwe: policjant, milicjant
glob|ciało niebieskie wchodzące w skład układu planetarnego
glut|potocznie: wydzielina z nosa smark
gniew|niezadowolenie irytacja złość wściekłość
goleń|odcinek nogi między stawem skokowym i kolanem podudzie, goleń (r. męski)
golonka|dolna część szynki z kością goleniową|potrawa przyrządzoną z takiego mięsa
goryl|małpa człekokształtna|potocznie o ochroniarzu
gorąco|upał, skwar, ciepło
gotować|doprowadzać daną potrawę do wrzenia|zajmować się kuchnią, przygotowywać gorące posiłki
gołąb|ptak średniej wielkości, żyje dziko lub oswojony, roślinożerny
grabie|narzędzie ogrodnicze służące do grabienia|konne lub ciągnikowe narzędzie rolnicze do zgrabiania pokosów siana lub resztek po sprzęcie zboża grabiarka, zgrabiarka
grad|jednostka kąta płaskiego gradus
granat|krzew lub drzewo niewielkich rozmiarów z rodziny granatowcowatych granatowiec|owoc granatowca
graty|gruchot potocznie: |stary, mało wartościowy, zniszczony sprzęt rupieć |stary, zniszczony lub podniszczony samochód dezel
grosz|moneta srebrna emitowana w średniowieczu w wielu krajach europejskich|współcześnie: drobna moneta w Polsce (1/100 złotego)
groszek|nazwisko
gruszka|owoc gruszy|irygator gumowy przypominający owoc gruszy
grypa|choroba zakaźna wywoływana przez wirusy, objawiająca się katarem, kaszlem, gorączką, bólem głowy, mięśni influenza
grzebień|przyrząd do czesania lub układania włosów|wypustka na głowie i dziobie u niektórych ptaków
grzmot|efekt akustyczny w postaci huku (suchego trzasku lub dudnienia), towarzyszący piorunowi wraz z błyskawicą|silny trzask, huk łomot, łoskot
grzyb|cudzożywny organizm plechowy, nieposiadający ciałek zieleni|nadziemna część organizmu plechowego, w kształcie kapelusza osadzonego na nóżce
grób|miejsce pochówku
guma|produkt otrzymywany z kauczuku przez wulkanizację|potocznie:|a) wyrób z gumy|b) prezerwatywa, gumka
gwiazda|ciało niebieskie składające się z plazmy i gazów świecące jasnym blaskiem na skutek reakcji termojądrowych zachodzących w jego wnętrzu|osoba znana publicznie, wyróżniająca się w jakiejś dziedzinie
gwóźdź|kawałek cienkiego pręta, po jednej stronie zaostrzonego, a po drugiej zakończonego główką
góra|wznosząca się wysoko nad otaczającym terenem wyniosłość skorupy ziemskiej|wyższa część czegoś
gąbka|porowata, wodochłonna poduszeczka używana przede wszystkim do mycia|prymitywne zwierzę wielokomórkowe żyjące głównie na dnie mórz
gęś|ptak żyjący dziko lub hodowany
głodny|odczuwający głód
głos|dźwięk artykułowany, mowa, śpiew|jakikolwiek dźwięk, brzmienie czegoś
głosować|wypowiadać się, oddając głos w sprawie, która ma być przedmiotem wspólnej decyzji
głowa|część ciała, w której znajdują się narządy zmysłów oraz mózg
głośnik|urządzenie służące do przetwarzania sygnałów elektrycznych na fale akustyczne|urządzenie służące do mechanicznego wzmacniania głosu
głuchy|niedosłyszący lub pozbawiony zdolności słyszenia|przenośnie: niewrażliwy, np. głuchy na ludzkie cierpienia
głupkowaty|będący objawem głupoty|głupawy, nierozgarnięty
hak|metalowy pręt zagięty na końcu służący do zaczepiania o coś, wieszania czegoś itp.|cios bokserski zadawany od dołu ręką zgiętą w łokciu
hamak|prostokątna siatka ze sznurka albo mocna tkanina, rozpinana pomiędzy dwoma słupami lub drzewami, przeznaczona do leżenia lub spania
hamulce|urządzenie służące do zmniejszania prędkości lub zatrzymywania
hantle|ciężarek do ćwiczeń gimnastycznych ciążek
harfa|instrument muzyczny szarpany arfa
hasło|myśl przewodnia, idea, slogan|sygnał do rozpoczęcia czegoś
hawaje|rodzaj spodni
herbata|roślina pochodząca z południowo-wschodniej Azji, z liści i pączków której sporządza się aromatyczny napar|napój z suszonych liści herbaty jedna porcja napoju
hip hop|hip-hop|subkultura młodzieżowa wywodząca się ze Stanów Zjednoczonych, której charakterystycznymi elementami są muzyka (rap), taniec (breakdance) i graffiti|styl w muzyce rozrywkowej wywodzący się z kultury hiphopowej
hipopotam|nazwa dwóch roślinożernych ssaków z rodziny hipopotamów, zamieszkujących Afrykę, prowadzących ziemnowodny tryb życia:|osiągający do 4,5 m długości hipopotam nilowy|hipopotam karłowaty - osiągający ok. 1,5 m długości
hiszpania|państwo w Europie ze stolicą w Madrycie Królestwo Hiszpanii
hokej|gra sportowa na lodzie lub na trawie hockey
holandia|państwo w Europie ze stolicą w Amsterdamie Królestwo Niderlandów
holownik|jednostka pływająca wykorzystywana przede wszystkim do holowania barek i dużych statków
homar|największy ze skorupiaków żyjący w Oceanie Atlantyckim
hydraulik|osoba zawodowo zajmująca się hydrauliką
igła|narzędzie do szycia, ostry pręcik z uszkiem do nawlekania nici|element urządzenia technicznego kształtem przypominający igłę iglica
indyk|ptak hodowany dla mięsa i piór
irlandia|wyspa na Oceanie Atlantyckim|państwo w Europie ze stolicą w Dublinie
irokezem|fryzura charakteryzująca się pasem dłuższych włosów, biegnących od górnej części czoła aż po kark, czasem krócej, popularna m.in. wśród punków
jabłko|owoc jabłoni
jacht|yacht (rzadziej)|statek żaglowy lub z silnikiem, służący do celów sportowych lub turystycznych|potocznie: luksusowa łódź
jacuzzi|[czytaj: dżakuz-i] jakuzzi|duża wanna z systemem napowietrzania wody i masaży wodnych|kąpiel w takiej wannie
jad|trująca wydzielina niektórych zwierząt, roślin czy bakterii|przenośnie: złośliwość, uszczypliwość
jajko|żeńska komórka jajowa niektórych zwierząt, składająca się z białka i żółtka w skorupce, używana jako produkt spożywczy
jamajka|gatunek rumu
japonia|państwo w Azji
jaskinia|próżnia, pustka w skale lub system takich próżni dostępnych dla człowieka, powstałych w sposób naturalny
jaskiniowiec|człowiek zamieszkujący jaskinie w epoce przedhistorycznej człowiek pierwotny
jaszczurka|niewielki gad o wydłużonym ciele pokrytym łuskami i długim, regenerującym się ogonem
jazda|przemieszczanie się z miejsca na miejsce za pomocą środków lokomocji|dawniej: kawaleria
jednorożec|mityczne stworzenie o jednym rogu na czole, mającym magiczne właściwości (m.in leczenie chorób i przynoszenie szczęścia osobie go posiadającej)
jeleń|potocznie: o człowieku niemądrym, naiwnym, łatwowiernym
jezioro|naturalny śródlądowy zbiornik wodny
jeść|spożywać pokarmy, odżywiać się
joga|indyjski system religijno-filozoficzny szukający sposobów osiągnięcia równowagi duchowej w ekstazie i kontemplacji|rodzaj gimnastyki ciała i umysłu mającej na celu odprężenie fizyczne i psychiczne
jogurt|produkt mleczarski o dość gęstej konsystencji, sporządzany z mleka
jordania|państwo w Azji ze stolicą w Ammanie Jordańskie Królestwo Haszymidzkie
jowisz|piąta według oddalenia od Słońca planeta Układu Słonecznego|w mitologii rzymskiej: najwyższy bóg
język|część ciała ułatwiająca rozdrabnianie pokarmu i formowanie kęsów|system znaków obejmujący gramatykę i słownictwo, służący porozumiewaniu się
kabel|przewód tworzony przez drut lub izolowane od siebie druty metalowe, zabezpieczone przed działaniami zewnętrznymi|miara długości równa 185,2 m (1/10 mili morskiej)
kabina|niewielkie pomieszczenie na statku lub w samolocie|wydzielone pomieszczenie, wyposażone w odpowiednie urządzenia, przeznaczone dla jednej osoby, np. kabina natryskowa
kaczka|ptak wodny z rzędu blaszkodziobych, dziki lub udomowiony, charakteryzujący się krótką szyją, spłaszczonym dziobem oraz krótkimi nogami|potrawa z tego ptaka
kaczor|samiec kaczki
kajak|mała łódź o wydłużonym kształcie
kajdanki|zdrobnienie od: kajdany
kaktus|roślina należąca do rodziny sukulentów łodygowych 1500-1800 gatunków
kalendarz|system rachuby dni i dłuższych odstępów czasu, opierający się na cyklu zmian pór roku i zmian faz Księżyca, np. kalendarz gregoriański, juliański|spis dni całego roku, z podziałem na miesiące i tygodnie
kamień|twarda, spoista i ciężka bryła skalna
kamizelka|część stroju bez rękawów i kołnierza, zakładana pod marynarkę lub wierzchnie okrycie
kanada|żartobliwie o bogactwie i dostatku
kanapka|prosty w przygotowaniu posiłek składający się z kromki chleba i dodatku (np. wędliny, sera, warzyw)|zdrobnienie od: kanapa
kangur|ssak z rodziny kangurowatych, australijski torbacz roślinożerny, żyjący na ziemi bądź na drzewach, poruszający się skokami na potężnych, długich, tylnych kończynach|w lotnictwie: podskok samolotu w trakcie nieumiejętnego lądowania
kapać|spadać, ściekać kroplami|strząsać krople, lać wolno kroplami
kapcie|(zwykle w liczbie mnogiej)|a) miękki, wygodny but do chodzenia po domu łapeć, papeć, papuć|b) potocznie: stary, przechodzony but|potocznie, często w wyrażeniu "złapać kapcia": opona lub dętka, z której zeszło powietrze, zwykle na skutek uszkodzenia guma (często w wyrażeniu "złapać gumę") także o piłce, z której uleciało powietrze flak
kapelusz|nakrycie głowy|(w botanice) górna część owocnika grzyba wytwarzająca zarodniki
kapitan|dawniej: okręt dowódcy lub admirała mała galera prowadzona przez naczelnego oficera dowodzącego galerami
kaptur|część wierzchniego ubrania nakrywająca głowę|stożkowata osłona
karabin|indywidualna długa broń strzelecka z lufą gwintowaną
karta|każdy element z kompletu kartoników oznaczonych umownymi znakami, służących do gry, stawiania pasjansa|spis i cennik potraw (menu) w restauracji, jadłodajni, kawiarni
karty|gra z użyciem specjalnie oznaczonych kartoników - kart do gry
kasjer|pracownik przyjmujący i wypłacający pieniądze|pracownik sprzedający bilety teatralne, kolejowe, kinowe itp.
kask|ochronne nakrycie głowy
kasyno|budynek, lokal rozrywkowy przeznaczony do gier hazardowych|rodzaj klubu, w którym co jakiś czas odbywają się spotkania towarzyskie, najczęściej kółka zainteresowań
kat|osoba wykonująca wyroki śmierci
katapultować|w lotnictwie:|wyrzucić, wyrzucać z samolotu fotel lub kabinę pilota, używając katapulty|użyć, używać katapulty do startu samolotu
kawa|napój przyrządzony z palonych i zmielonych ziaren kawowca lub namiastka kawy przyrządzona z ziaren zbóż, żołędzi itp. także: porcja tego napoju |wiecznie zielone drzewo lub krzew z rodziny marzanowatych, o skórzastych, ciemnozielonych liściach i wonnych, białych lub zielonych kwiatach, uprawiane w strefie międzyzwrotnikowej ze względu na nasiona (tzw. ziarna kawy) zawierające kofeinę, używane do przyrządzania pobudzającego napoju - kawy kawowiec także: odpowiednio przygotowane nasiona tej rośliny
kałamarnica|głowonóg posiadający walcowate ciało z licznymi ramionami otaczającymi otwór gębowy, poruszający się ruchem odrzutowym, żyjący gromadnie w Atlantyku i Morzu Śródziemnym kalmar loligo
kałuże|coś rozlanego|zagłębienie w ziemi z błotnistą wodą z opadów lub ścieków
kciuk|pierwszy palec u dłoni człowieka
keczup|[czytaj: keczup (zalecane) lub keczap] ostry, zimny sos pomidorowy do potraw ketchup
kelner|pracownik obsługujący gości w restauracji
kelnerka|kobieta wykonująca zawód kelnera
kemping|camping|ogrodzony teren wyposażony w umywalnie, elektryczność itp., przystosowany do obozowania w namiotach albo w domkach (przyczepach) kempingowych|czasowe przebywanie na takim terenie
kichać|gwałtownie wyrzucać powietrze na skutek podrażnienia śluzówek w nosie przez drobne ciała obce
kieszeń|kawałek materiału, w ten sposób przyszytego, przymocowanego do ubrania, plecaka itp., by dawał możliwość schowania podręcznych przedmiotów, pieniędzy, dokumentów itp.|zasoby pieniężne
kieszonka|mała kieszeń
kieł|ząb znajdujący się między siekaczami a zębami trzonowymi u ssaków|zaczątek rośliny w pierwszej fazie wzrostu, złożony z korzonka i pędu pączkowego kiełek
kiełbasa|wyrób wędliniarski z mielonego mięsa w osłonce z jelita zwierzęcego albo sztucznej
kijanka|larwa płazów bezogonowych|drewniana łopatka służąca dawniej na wsi do prania bielizny i obijania lnu
kikut|część kończyny lub palca pozostała po amputacji lub istniejąca od urodzenia część narządu wewnętrznego pozostała po wycięciu fragmentu tego narządu
klamka|ruchoma część zamka przy drzwiach rączka
klamra|zapięcie pasa, butów i ubrania|rodzaj nawiasu w postaci { i }
klasa|kategoria czegoś|grupa społeczna
klaskać|uderzać ręką o rękę powodując powstanie charakterystycznego dźwięku bić brawo|uderzać czymś, powodując powstawanie charakterystycznego odgłosu przypominającego uderzenie dłonią o dłoń klapać, kłapać, kląskać, klekotać
klatka|pomieszczenie o ścianach z prętów|małe i ciasne pomieszczenie
klawiatura|rząd klawiszy w instrumentach muzycznych|odpowiedni układ kilku rzędów klawiszy, który obsługuje różnego rodzaju maszyny i mechanizmy
klawisz|wąska płytka w instrumentach muzycznych, wprowadzająca w ruch mechanizm młoteczkowy w instrumentach strunowych lub otwierająca i odcinająca dopływ powietrza do piszczałek, stroików|przycisk
klej|lepka substancja służąca do sklejania, łączenia przedmiotów
klient|petent, interesant, kupujący|obywatel starożytnego Rzymu, będący pod opieką prawną patrycjusza
klif|urwisty brzeg morza i jeziora faleza
klin|kawałek drewna lub metalu o zaostrzonym kształcie służący do rozbijania twardych materiałów,|coś w kształcie trójkąta ostrego,
klops|upieczone lub usmażone mięso mielone|potocznie: porażka, niepowodzenie, fiasko
klub|organizacja skupiająca ludzi określonego zawodu lub wspólnych zainteresowań, mająca na celu organizowanie rozrywek, gier itp|lokal rozrywkowy czynny wieczorem i nocą
klucz|narzędzie do zamykania i otwierania zamków i kłódek|szyfr
kobieta|dorosły człowiek płci żeńskiej
koc|gruba, ciepła tkanina używana do przykrycia pled|rodzaj sieci służącej do połowu ryb pod lodem
kochanie|osoba kochana przedmiot miłości
kogut|samiec kury domowej, a także bażanta, cietrzewia i innych kuraków|przenośnie:|a) kobieciarz|b) człowiek zadziorny, zawadiaka
kokon|oprzęd niektórych owadów, np. jedwabnika morwowego|zewnętrzna powłoka osłaniająca jaja wielu zwierząt, np. pijawek, pajęczaków
koktajl|cocktail, koktejl (przestarzale)|napój z mieszaniny alkoholi z dodatkiem m.in. soku|napój orzeźwiający sporządzany z mieszaniny soków owocowych, mleka i różnych dodatków smakowych
kolano|część nogi|miejsce kolistego skrętu ulicy, rzeki itp.
komar|dokuczliwy owad wilgociolubny, żywiący się krwią ludzi i zwierząt, często przenoszący bakterie chorobotwórcze
kometa|nietrwałe ciało niebieskie składające się z jądra o powłoce gazowej i warkocza poruszające się po orbitach o dużych mimośrodach
komiczny|dotyczący komizmu|zabawny, wywołujący śmiech
komin|pionowa konstrukcja, zapewniająca przepływ powietrza|wąskie wcięcie w stoku górskim
kompas|przyrząd służący do określenia kierunku na powierzchni ziemi, wykorzystujący właściwości igły magnetycznej
koncert|publiczne wykonanie jednego lub kilku utworów muzycznych|instrumentalny utwór muzyczny przeznaczony dla solisty z towarzyszeniem orkiestry
koniec|chwila, w której coś przestaje istnieć, np. koniec świata, miłości, młodości kres, schyłek, zmierzch|fragment będący ostatnią częścią większej całości, np. koniec filmu, książki, przemówienia zakończenie
kopać|uderzać nogą, bić nogą, dawać kopniaki|robić dół, ryć
korek|tkanka wtórna okrywająca łodygi, pnie, korzenie, bulwy, wytwarzana przez miazgę|surowiec uzyskiwany z kory niektórych drzew korek użytkowy
korona|symbol władzy monarchy|przenośnie: władza królewska
korzeń|część rośliny znajdująca się pod ziemią
kostka|zdrobnienie od: kość|trójkątna płytka z masy lub kości używana do gry na gitarze
kosz|rodzaj pojemnika koszyk|pojemnik na śmieci, odpadki
kot|zwierzę domowe z rodziny kotowatych, o miękkiej sierści, ostrych pazurach, długim ogonie, mające znakomity słuch i wzrok, żyjące zwykle 15-20 lat|przedstawiciel rodziny ssaków drapieżnych - kotów (np. żbik, lew, lampart)
kotek|mały kot zdrobnienie od: kot|pieszczotliwe określenie miłej, bliskiej osoby
kotwica|stalowa konstrukcja z trzonem i ramionami, która rzucona ze statku (na linie lub łańcuchu), zagłębia się w dno i utrzymuje statek w jednym miejscu
kowboj|pasterz bydła, koni w Ameryce Północnej, charakteryzujący się specyficznym, gł. skórzanym ubiorem: szerokim kapeluszem, pasem z przypiętą bronią cowboy
koza|ssak z rodziny krętorogich|ryba z rodziny piskorzowatych
kołdra|watowane, puchowe lub wełniane przykrycie będące częścią pościeli
kołek|podłużny kawałek ociosanego drewna także: gładki sworzeń drewniany lub metalowy
koło|część płaszczyzny ograniczona okręgiem|część pojazdu umożliwiająca jego ruch
koń|zwykle łącznie z przymiotnikiem "stary":|pejoratywne określenie na dorosłą osobę zachowującą się jak dziecko|poufałe o koledze lub przyjacielu
kości|gra hazardowa, polegająca na rzucaniu sześcianikami, których ścianki oznacza się cyframi od 1 do 6|pot. ciało człowieka
kościół|ogół wyznawców jakiejś religii Kościół|instytucja kościelna, zwłaszcza katolicka, reprezentowana przez duchownych Kościół
kość|część szkieletu kręgowców, zbudowana z tkanki kostnej|sześcian z zaznaczonymi punktami przeznaczony do gry * forma narzędnika l.mn. "kościami" możliwa tylko w wyrażeniu "poczciwy/dobry/uczciwy z kościami" - prawdziwie, do gruntu poczciwy, dobry
krab|skorupiak z podrzędu o tej samej nazwie
kran|zawór kurkowy kurek|urządzenie do podnoszenia i przemieszczania ciężarów
krata|krzyżujące się, przeplatające się pręty metalowe mające stanowić przeszkodę trudną do przejścia ogrodzenie, brama itp. wykonane z takich prętów|wzór tworzony przez prostopadle krzyżujące się linie materiał w taki wzór
krawędź|linia zetknięcia się dwóch powierzchni lub wąski pas jakiejś powierzchni przy samym jej brzegu|metalowy ochraniacz nakładany na brzeg narty
kraść|przywłaszczać bezprawnie cudzą własność
kreda|miękka, rozcieralna, wapienna skała osadowa składająca się gł. z węglanowych szkieletów organizmów morskich|biała substancja wytworzona ze skały o tej samej nazwie
kredens|mebel, składający się z szafek i szuflad
krew|płynna tkanka pełniąca u kręgowców wiele ważnych ról, m.in. transport tlenu, dwutlenku węgla i innych substancji, funkcje obronne|żywy temperament
krewetka|skorupiak długości 2-30 cm, poławiany masowo ze względu na smaczne mięso
krok|ruch wykonywany przy chodzeniu stąpanie kroczenie|czyn, posunięcie
kropki|potocznie:|deseń na tkaninie, papierze itp., w postaci wielu punktów, plamek|materiał w taki deseń
krowa|samica bydła domowego, hodowana ze względu na mleko i mięso|dorosła samica różnych ssaków przeżuwających, parzystokopytnych, np. jaka, bizona, żubra, tura, zebu
krupon|grzbietowa część wyprawionej skóry bydlęcej lub świńskiej, używana na podeszwy słupiec
kryształ|ciało, w którym cząstki elementarne rozmieszczone są według reguł geometrycznych,|ciężkie szkło do wyrobu naczyń i luster,
krzesło|mebel składający się z nóg, siedzenia i oparcia
krzyk|podniesienie głosu
król|władca koronowany monarcha|przenośnie: ktoś najlepszy w swojej dziedzinie, wyróżniający się wśród otoczenia
królik|gatunek roślinożernego ssaka z rodziny zającowatych
królowa|władczyni w królestwie monarchini żona króla|przen.|a) czule a. żart. o kobiecie|b) coś (gł. kobieta) wybijającego się na czoło
krótki|mający małą długość|trwający niedługo krótkotrwały
kręgle|gra polegająca na przewróceniu kulą rzuconą po długim torze odpowiednio ustawionych 9 słupków
książka|arkusze papieru zadrukowane tekstem literackim lub użytkowym, zbroszurowane i oprawione razem|dzieło literackie wydane drukiem lub przygotowane do wydania
książę|niekoronowany władca państwa lub pewnego terytorium|członek rodziny panującej
księżniczka|córka księcia
księżyc|Księżyc postrzegany jako tarcza na niebie lub jej część|ciało niebieskie krążące dokoła jakiejś planety
kształt|ogólny zarys czegoś forma postać
kuba|wyspa w archipelagu Wielkie Antyle|państwo w Ameryce Środkowej Republika Kuby
kubek|naczynie do picia z uchwytem do trzymania (uchem)
kuchenka|zdrobnienie od: kuchnia
kuchnia|piec z blatem, służący do gotowania potraw|pomieszczenie przeznaczone do przygotowywania posiłków
kucyk|mały koń, kuc|zwykle w lm: rodzaj uczesania dziewczynek, dość krótkie włosy związane przy uszach również niedługie, cienkie warkoczyki
kuks|cios łokciem albo pięścią kuksaniec szturchaniec|akcje przedsiębiorstwa zajmującego się wydobyciem surowców naturalnych
kukurydza|jednoroczna roślina zbożowa z rodziny wiechlinowatych, o bardzo wysokiej łodydze, szerokich liściach i dużych ziarnach zebranych w kolby, uprawiana powszechnie na ziarno pastewne, dla celów przemysłowych i spożywczych (kukurydza zwykła), jako pasza dla bydła (kukurydza pastewna) oraz dla celów konsumpcyjnych jako warzywo (kukurydza cukrowa)|kolba tej rośliny
kula|bryła ograniczona sferą|przedmiot kształtu tej bryły
kult|religijna cześć oddawana siłom nadprzyrodzonym, rzeczom lub osobom|całokształt praktyk religijnych i obrzędów, będący jednym z zasadniczych aspektów religii
kurczak|pisklę kury kurczę|młody kogut kurak
kurtka|krótkie wierzchnie okrycie
kurtyna|zasłona w teatrze oddzielająca widownię od sceny|bariera oddzielająca od siebie dwa obszary
kusza|rodzaj łuku stalowego umocowanego na kolbie z lewarem do napinania cięciwy|inna nazwa balisty
kwak|kwakanie
kwiat|część rośliny będąca organem rozmnażania płciowego|roślina kwitnąca
kąt|część płaszczyzny ograniczona przez dwie półproste o wspólnym początku|miejsce przy stykających się ścianach
kędzior|pasemko wijących się włosów lok pukiel
kłopot|trudna, skomplikowana lub przykra sytuacja, budząca niepokój, wymagająca jakiegoś działania
kły|ząb znajdujący się między siekaczami a zębami trzonowymi u ssaków|zaczątek rośliny w pierwszej fazie wzrostu, złożony z korzonka i pędu pączkowego kiełek
kłódka|rodzaj przenośnego, zamykanego kluczem zamka, spinającego skoble, haki itp.
labirynt|starożytna budowla o skomplikowanym układzie licznych sal i korytarzy|w przenośni: zawiły splot wydarzeń, sytuacja bez wyjścia zamęt
laboratorium|pomieszczenie wyposażone w specjalistyczny sprzęt, przeznaczone do prowadzenia doświadczeń, analiz, kontroli procesów technologicznych itp.
lalka|dziecięca zabawka w postaci miniaturowego człowieka, zwykle bobasa, dziewczyny, kobiety itp. używana też jako przedmiot dekoracyjny|figurka mająca zastąpić postać aktora w spektaklu kukiełka jawajka marionetka kukła
lampa|urządzenie, które służy do wytwarzania sztucznego światła za pomocą prądu elektrycznego, oleju lub gazu
lampart|duży drapieżny kot leopard, pantera
las|zwarty zbiór roślinności z przewagą roślin drzewiastych|przen. (np. sztandarów) wielka liczba, masa
latawiec|potocznie: człowiek o hulaszczym trybie życia, często postępujący lekkomyślnie hulaka, trzpiot, lekkoduch
latać|unosić się w powietrzu|odbywać podróż w samolocie lub innej latającej maszynie
lato|pora roku pomiędzy wiosną a jesienią
latryna|prowizoryczna ubikacja w postaci dołu, urządzana w warunkach polowych
lawa|magma, która wydobyła się na powierzchnię ziemi (najczęściej wskutek erupcji wulkanu)
laweta|platforma służąca do przewozu samochodów|podstawa armaty podpierająca lufę i przyrządy celownicze
lejek|zbiornik z rurką służący do przelewania cieczy
lekarstwo|lek|substancja chemiczna (lub ich zespół) stosowana w lecznictwie jako środek przeciw chorobom, bólom itp.|przen. metoda zaradcza, sposób, pomoc, rada
lekarz|osoba, która zawodowo zajmuje się leczeniem
lekki|mający niewielki ciężar|o delikatnych kształtach, zwinny, nieociężały
lemoniada|chłodzący napój z soku cytrynowego, cukru i wody, najczęściej gazowany i aromatyzowany cytrynada
lew| duży ssak drapieżny z rodziny kotów
lewo|karta lub karty jednorazowo zdobyte w czasie gry w karty
limonka|zdrobnienie od: limona limetka
lina|rodzaj grubego sznura
linia|kreska|droga, połączenie
lis|ssak z rodziny psowatych
lista|spis, wykaz ludzi, rzeczy lub spraw
listonosz|doręczyciel pocztowy
lizać|przesuwać po czymś językiem|lizać się - pot. całować się namiętnie
liść|organ roślin naczyniowych służący m.in. do asymilowania dwutlenku węgla z powietrza
loda|potocznie: porcja lodów
lodówka|urządzenie chłodzące, służące do przechowywania żywności|gatunek kaczki morskiej
londyn|stolica Wielkiej Brytanii
lot|poruszanie się w powietrzu, latanie
lotnisko|teren przystosowany do lądowań i startów samolotów
lukier|polewa z roztopionego cukru, niekiedy barwiona, używana do dekoracji ciast, tortów
lustro|szkło pokryte warstwą srebra lub aluminium o właściwościach odbijających rzeczy znajdujące się przed nim.|przyrząd geodezyjny (zazwyczaj razem z rozkładaną tyczką) odbijający wiązkę lasera wysyłaną przez dalmierz w celu pomiaru odległości
lód|woda w stanie stałym jej zamarznięta powierzchnia
macka|ruchomy wyrostek ciała bezkręgowców, służący jako narząd chwytny lub dotykowy macek|prosty przyrząd saperski do wykrywania min - ostro zakończony pręt stalowy na długim trzonku
maczać|zanurzać coś w jakimś płynie lub w czymś sypkim
magia|ogół wiedzy tajemnej i wiary w możliwość wpływania na świat rzeczywisty za pomocą specjalnych obrzędów, zaklęć, czarów|magiczne obrzędy i zaklęcia wywodzące się z tej wiedzy czary
magik|osoba pokazująca sztuczki magiczne oparte na zręczności iluzjonista, sztukmistrz, kuglarz, prestidigitator|potocznie: człowiek przebiegły, sprytny spryciarz, cwaniak
magnes|element wykonany z materiału magnetycznie twardego, namagnesowany do stanu nasycenia, stanowiący źródło stałego pola magnetycznego|przenośnie: coś co budzi zainteresowanie, przyciąga
majtki|dolna część bielizny zakrywająca pośladki i genitalia|potocznie: krótkie spodenki chłopięce
makaron|produkt z ciasta przygotowanego z mąki pszennej, z dodatkiem jaj i soli, w kształcie rurek, nitek, muszelek|tekst pełen makaronizmów makaronizm
makijaż|make-up, maquillage (przestarzale)|kosmetyki (np. puder, szminka) nałożone na twarz w celu jej upiększenia|nakładanie na twarz odpowiednich kosmetyków (np. szminki, różu) w celu upiększenia malowanie (się)
malarz|artysta zajmujący się malarstwem|rzemieślnik zarabiający malowaniem ścian, mebli itp.
mama|potocznie:|matka|teściowa
mamut|wymarły słoń, zamieszkujący w okresie lodowcowym Europę, północną Azję i Amerykę Północną|odmiana żółtej fasoli szparagowej o szerokich strąkach
mapa|obraz powierzchni czegoś (zwykle Ziemi, nieba) przedstawiony w odpowiedniej skali za pomocą ustalonych znaków także innego rodzaju przedstawienie graficzne, jak np. mapa genetyczna, mapa percepcji itd.
marchewka|mała marchew|w przenośni potencjalna nagroda za wykonaną pracę
margaryna|tłuszcz spożywczy konsystencją przypominający masło, wytwarzany głównie z olei roślinnych, najczęściej z dodatkiem substancji smakowych, barwiących i witamin
marionetka|teatralna lalka poruszana za pomocą nitek lub drutów|człowiek całkowicie podległy wpływowi kogoś innego, pozostający na czyichś usługach
marmur|skała metamorficzna ceniona jako materiał rzeźbiarski
marynata|zalewa, sporządzana na bazie octu, do marynowania|warzywa, mięso itp. konserwowane w occie i przyprawach
masaż|zabieg leczniczy polegający na rozcieraniu, ugniataniu ciała
maska|nakładana na twarz lub głowę, wymodelowana w drzewie lub innym tworzywie, stylizowana twarz ludzka lub głowa zwierzęca|okład na twarz
masło|produkt spożywczy otrzymywany z mleka krowiego w wyniku zmaślenia śmietanki lub śmietany
mata|płat plecionki z różnych tworzyw (zwykle ze słomy), używany do przykrywania podłóg, osłaniania ścian, ładunków towarowych itp.|grube, elastyczne nakrycie na podłogę, używane podczas niektórych ćwiczeń i zawodów sportowych
materac|rodzaj poduszki z płótna, gumy itp. wypełnionej włosiem, trawą, powietrzem, służącej jako element łóżka lub jako samodzielny sprzęt
małpa|zwierzę o chwytnych kończynach i dobrze rozwiniętych półkulach mózgowych, żyjące najczęściej w lasach tropikalnych, prowadzące nadrzewny tryb życia|potocznie: znak @, używany w adresach internetowych, będący skrótem angielskiego "at"
mały|niewielki, niski, nieduży|przenośnie: zwykły, pospolity, małowartościowy
małż|przedstawiciel gromady mięczaków mających ciało bocznie spłaszczone, okryte dwoma fałdami płaszcza wytwarzającego dwuczęściową muszlę, a w jamie płaszcza parzyste skrzela
małżeństwo|związek prawny mężczyzny i kobiety|małżonkowie
medalik|mały medal z wizerunkiem Chrystusa lub świętych, zwykle noszony na łańcuszku na szyi przez katolików
meksyk|potocznie o rozprzężeniu, awanturze, bałaganie|rodzaj tkaniny
melodia|obok rytmu i harmonii jeden z podstawowych elementów dzieła muzycznego
metr|jednostka długości, podstawowa w układzie SI,|miarka metrowej długości z podziałką,
metro|system transportu w dużych miastach w postaci kolei elektrycznej, zwykle podziemnej
mewa|biały lub jasnopopielaty ptak z rodziny o tej samej nazwie, żyjący na wybrzeżach mórz, oceanów, czasem wód śródlądowych
mgła|zawiesina malutkich kropelek wody występująca w przyziemnej warstwie powietrza|przen. coś przejrzystego, zwiewnego (np. para, cienka tkanina) obłok
miasto|duży obszar intensywnie rozwijający się gospodarczo i kulturalnie, podległy odrębnej administracji oraz zamieszkiwany przez osoby niezwiązane z pracą na roli|ogół społeczeństwa zamieszkujący ten obszar
miauczeć|o kocie: wydawać charakterystyczny głos|potocznie o człowieku: płaczliwie o coś prosić
miecz|metalowa broń sieczna|płaska płyta, najczęściej metalowa, wysuwana poniżej dna statku służąca do utrzymywania go w pionie i pozwalająca płynąć "pod wiatr"
mieszkanie|pomieszczenie przeznaczone do mieszkania
migać|poruszać się szybko, sprawiając kłopoty patrzącemu świecić przerywanym światłem, mienić się|poruszać czymś szybko
mikser|pracownik baru mieszający drinki,|pracownik radia lub telewizji zajmujący się miksowaniem dźwięku lub obrazu
miotła|kij z włosami na końcu służący do sprzątania
miska|naczynie podobne z kształtu do spłaszczonej półkuli zawartość tego naczynia|o czymś przypominającym to naczynie
mięczak|zwierzę bezkręgowe o miękkim ciele okrytym zwykle muszlą, wodne lub rzadziej lądowe|pogardliwie: ktoś słaby, o słabym charakterze
mięsień|narząd ruchu człowieka i zwierząt zbudowany z tkanki mięśniowej, której komórki zawierają włókna kurczliwe
mięso|jadalne umięśnienie szkieletowe zwierząt, ludzi potrawa z niego przyrządzana|potocznie: miękkie części ciała człowieka
mięta|dziko rosnąca roślina zielna należąca do rodziny wargowych, niektóre jej gatunki uprawiane jako rośliny ozdobne lub lecznicze|napar z liści mięty pieprzowej
miłość|głębokie przywiązanie do kogoś lub czegoś silne, namiętne uczucie
mleko|wydzielina gruczołów mlekowych samic ssaków, służąca jako pokarm dla młodych|(potocznie) mleko krowie
moc|(wielka) siła (fizyczna lub duchowa), potęga|mozliwość, zdolność
mogą|mieć odpowiednie warunki (zdolności, środki itp.), by czegoś dokonać zdołać|mieć prawo do czegoś
mokro|potocznie: uczucie wilgotności, kontaktu ciała z ciekłą substancją
moneta|metalowy pieniądz
monocyklu|rower o jednym kole, bez kierownicy, używany w cyrku do jazdy figurowej
monopol|wyłączne prawo przedsiębiorstwa do produkcji lub handlu w jakiejś dziedzinie przedsiębiorstwo posiadające taką wyłączność|czyjeś wyłączne prawo do czegoś
morderca|przestępca dokonujący morderstwa, zabójstwa
mors|ssak z rzędu płetwonogich zamieszkujący morza arktyczne koń morski|osoba praktykująca kąpiele w lodowatej wodzie
morski|przymiotnik od : morze
morze|dawniej o dżumie, zarazie lub też o śmierci
most|budowla łącząca brzegi rzeki lub innej przeszkody wodnej, umożliwiająca jej przebycie|rodzaj protezy stomatologicznej mostek
mrówka|gatunek owada z rodziny błonkoskrzydłych
mrówki|gatunek owada z rodziny błonkoskrzydłych
muczeć|o bydle: wydawać charakterystyczny dla siebie, niski, przeciągły głos ryczeć
mumia|zwłoki uchronione przed rozkładem w sposób naturalny lub w wyniku zabiegów konserwujących|potocznie: osoba chuda, wychudzona
muszka|rodzaj krawata o kształcie kokardy mucha|mała mucha (owad)
muszla|skorupa małża lub ślimaka |przedmiot w kształcie muszli
musztarda|ostra przyprawa do potraw sporządzona z nasion gorczycy
muza|każda z dziewięciu córek Zeusa, mitologicznych opiekunek sztuk pięknych i nauki|twórczość artystyczna
muzeum|instytucja gromadząca zbiory zabytków historii, sztuki itp. organizująca ich wystawy
muzyka|dziedzina sztuki, której tworzywem artystycznym są dźwięki zorganizowane w kompozycyjną całość utwory, melodie wykonywane na instrumentach lub przez głos ludzki komponowanie, granie, śpiewanie
mydło|substancja stosowana do mycia|w dominie: puste pole na klocku
mysz|niewielki gryzoń z rodziny myszowatych|urządzenie peryferyjne komputera, do pewnego stopnia zastępujące klawiaturę
mówić|używać słów w celu komunikacji, wypowiadać słowa
mózg|zespół najwyższych ośrodków nerwowych u kręgowców, znajdujący się w jamie czaszki mózgowie|umysł, rozum
mądry|władający rozumem, mający dużą wiedzą i inteligencję, który potrafi w odpowiedni sposób wykorzystać rozumny, rozsądny, bystry, błyskotliwy|świadczący o czyjejś erudycji, inteligencji, oczytaniu, mający rozumną treść rozsądny, sensowny, logiczny, przemyślany
mąka|produkt otrzymywany przez zmielenie nasion niektórych zbóż
mąż|określenie używane w stosunku do mężczyzny pozostającego w związku małżeńskim małżonek|wzniośle, patetycznie o mężczyźnie, najczęściej ze względu na jego pozytywne cechy charakteru, umysłu
młody|mający niewiele lat, niedojrzały
młot|narzędzie|wulgarnie o kimś nierozgarniętym
mściciele|osoba, która szuka zemsty, mści się
naczynia|przedmiot użytkowy służący do przechowywania, przyrządzania czegoś, najczęściej potraw|(zwykle w lm.) w organizmie ludzkim lub zwierzęcym: rurkowaty przewód służący do transportu krwi lub limfy
nadczłowiek|ktoś o wyjątkowych zdolnościach
nadgarstek|staw łaczący dłoń z ramieniem
nagroda|wyróżnienie|rekompensata, odszkodowanie
nakolanniki|ochraniacz na kolano używany np. przez sportowców lub podczas pracy wykonywanej w pozycji klęczącej
naleśnik|potrawa w postaci bardzo cienkiego placka z ciasta usmażonego na patelni, zawiniętego z dowolnym farszem
naleśniki|potrawa w postaci bardzo cienkiego placka z ciasta usmażonego na patelni, zawiniętego z dowolnym farszem
namiot|rodzaj przenośnego schronienia używanego przez jedną lub więcej osób
napęd|urządzenie napędzające maszynę|energia wprawiająca w ruch urządzenie techniczne lub jakiś element
narty|podłużna płoza służąca do jazdy po śniegu lub wodzie
narzędzie|prosty w obsłudze przedmiot służący do bezpośredniego oddziaływania na coś, czego zwykły człowiek nie mógłby wykonać gołymi rękami lub z większym trudem niż z owym narzędziem
nasienie|organ rozrodczy roślin nasiennych nasiono|dawniej: ród, potomstwo, dziecko dziś tylko w wyrażeniu "dziadowskie (złodziejskie, podłe itp.) nasienie" - wyzwisko
nastolatek|potocznie: chłopiec w wieku od 11 do 19 lat kilkunastolatek
naszyjnik|ozdoba noszona przez kobiety na szyi
nauczyciel|osoba, która zawodowo zajmuje się edukacją - uczeniem, kształceniem kogoś edukator|przenośnie: czynnik kształtujący czyjąś świadomość, np.: Doświadczenie jest najlepszym nauczycielem.
nauka|kształcenie, pouczanie|usystematyzowana wiedza ludzka
nauszniki|osłona na ucho część hełmu lub czapki okrywająca ucho
nawałnica|gwałtowne zjawisko atmosferyczne połączone z silnym wiatrem, np. ulewa, burza, gradobicie, śnieżyca, wichura zawierucha|wstrząs dziejowy rewolucja, rebelia
nazwa|wyraz lub kilka wyrazów oznaczających kogoś lub coś
neptun|pierwiastek chemiczny o symbolu Np
nerka|organ w ciele zwierząt i ludzi służący do filtrowania krwi|naczynie w kształcie tego organu, używane m.in. przy opatrunkach
netto|w znaczeniu rzeczownika: waga bez opakowania
nie|partykuła przecząca
niebezpieczeństwo|stan zagrożenia
niebieski|mający kolor bezchmurnego nieba błękitny, modry
niebo|pozorne sklepienie nad Ziemią firmament, niebiosa (podniośle)|w wielu religiach:|a) siedziba Boga, bogów, dusz zmarłych|b) Bóg, opatrzność
niechlujny|wyróżniający się brakiem czystości, porządku zaniedbany, brudny
niedobitek|(zwykle w liczbie mnogiej) osoba ocalała jako nieliczna z bitwy, pogromu itp.
niedźwiedź|ssak drapieżny z rodziny o tej samej nazwie|żartobliwie lub złośliwie o człowieku niezgrabnym, nieumiejącym się poruszać lub zachować
niegodziwy|książkowe: odpowiedni, uczciwy (zwłaszcza, jeśli chodzi o jakąś zapłatę, np. napiwek)
niemcy|Republika Federalna Niemiec państwo w Europie
nietoperz|latający ssak, u którego powierzchnie lotne tworzą elastyczne błony skórne rozpięte między bokami ciała a kończynami, prowadzący nocny tryb życia, mający bardzo rozwinięty zmysł słuchu, posługujący się echolokacją dla orientacji przestrzennej
nieśmiały|odważny, nietracący pewności siebie, nielękający się niebezpieczeństw|świadczący o czyjejś odwadze, pewności siebie
nikiel|pierwiastek chemiczny o symbolu Ni, srebrzystobiały metal, dość twardy, kowalny, trudno topliwy|potocznie: przedmiot niklowany
niska|charakteryzujący się niewielkością danej kategorii pojęciowej (np. wzrostu - niski człowiek, dom wielkości - niskie podatki wysokości - niskie chmury, niskie stanowisko, niski głos)
noc|czas od zachodu do wschodu słońca|środ. nocna zmiana w pracy
noga|kończyna dolna człowieka kończyna zwierzęcia|stopa
norwegia|państwo w Europie ze stolicą w Oslo Królestwo Norwegii
nos|narząd powonienia|wysunięta, zwężona część czegoś, dziób
notatnik|zeszyt do notatek|forma literacka zawierająca wrażenia i przemyślenia autora spisane w postaci luźnych notatek
nozdrze|jeden z dwóch otworów nosa
noże|narzędzie składające się z ostrza na trzonku, służące do krojenia, cięcia
nożyczki|narzędzie służące do przecinania m.in. papieru, posiadające dwa ostrza
numer|liczba umieszczona na czymś|rzecz, rzadziej człowiek, oznaczona kolejną liczbą
nóż|narzędzie składające się z ostrza na trzonku, służące do krojenia, cięcia
obcas|tylna, spodnia część buta podpierająca piętę
obcy|nie należący do jakiegoś kręgu osób, spraw, rzeczy niewłaściwy komuś, nie objęty czyimiś zainteresowaniami
obiad|najobfitszy, gorący posiłek spożywany najczęściej w środku dnia
obiektyw|soczewka lub zespół soczewek, za pomocą których można obserwować rzeczywistość (obiektyw lunety) lub zdejmować jej obraz (obiektyw aparatu)
obraz|ogólne określenie grafiki dwuwymiarowej dzieło sztuki, wykonane na papierze, płótnie lub desce|odzwierciedlenie czegoś
obrazek|inaczej rysunek lub malowidło
obrońca|ktoś, kto występuje w czyjejś obronie|prawnik broniący oskarżonego mecenas adwokat
obręcz|koło wykonane z paska metalu, drewna itp. o różnorodnym zastosowaniu.|okrąg opasujący coś obwód otok
oczy|narząd wzroku
oddech|pobieranie tlenu do organizmu poprzez odruchowe wciąganie powietrza do płuc i wydychanie|wydychane powietrze
odkurzać|czyścić, trzepać, wycierać z kurzu, pozbywać się kurzu za pomocą odkurzacza
odznaka|[czytaj: od-znaka]|medal, order, odznaczenie|znaczek przynależności organizacyjnej
ofiara|osoba lub zwierzę, które doznały przemocy lub straciły życie|osoba niezaradna, niezdara
ogień|płomienie i ciepło towarzyszące paleniu się ciał|palenie się, płomień
ognisko|płonący stos drewna lub chrustu|spotkanie towarzyskie przy takim stosie
ogon|u zwierząt kręgowych: tylna część ciała, złożona zwykle z coraz drobniejszych kręgów|tylna, zwężona część ciała wielu bezkręgowców
ogrodnik|osoba zajmująca się zakładaniem i uprawą ogrodu
ogród|teren zasadzony roślinami (kwiatowy, botaniczny) lub warzywami (warzywny)|ogród zoologiczny zoo
ojciec|mężczyzna, który ma własne dziecko lub dzieci rodzic tata|w niektórych zakonach: tytuł używany w stosunku do zakonnika po święceniach
okna|otwór w ścianie lub dachu budynku pozwalający m.in. na wentylację pomieszczenia, zobaczenie tego, co jest na zewnątrz|szyba oprawiona w ramę znajdująca się w takim otworze
okno|otwór w ścianie lub dachu budynku pozwalający m.in. na wentylację pomieszczenia, zobaczenie tego, co jest na zewnątrz|szyba oprawiona w ramę znajdująca się w takim otworze
oko|narząd wzroku
okrąg|linia ograniczająca płaszczyznę o formie kolistej okręg, krąg, obwód|przedmiot o kulistym kształcie krąg, okręg
okulary|przyrząd optyczny znoszący lub zmniejszający skutki wrodzonej lub nabytej wady wzroku takiej jak nadwzroczność, krótkowzroczność, astygmatyzm (niezborność), czy starczowzroczność
olej|ciekła substancja tłuszczowa|płynny produkt destylacji ropy naftowej, smoły węglowej
olimpiada|starogreckie igrzyska sportowe igrzyska olimpijskie|zawody sportowe organizowane co 4 lata od 1896 roku na wzór starożytnych igrzyska olimpijskie
omlet|smażony placek zrobiony z jajek oraz mąki
onz|Organizacja Narodów Zjednoczonych, uniwersalna organizacja międzynarodowa działająca od roku 1945
opaska|to, co służy do opasania, otoczenia czegoś|papierowy pasek oklejający niekiedy przesyłane pismo, broszurę, plik banknotów
opiekacz|urządzenie do opiekania pieczywa i robienia grzanek toster
opląt|włókna ochronne niektórych poczwarek
opona|zewnętrzna, gumowa część koła
orbita|tor, po którym porusza się, pod wpływem przyciągania, jedno ciało wokół innego (np. elektron wokół jądra atomowego, Mars wokół Słońca)|krąg czyichś wpływów, zainteresowań
ordynans|żołnierz pełniący służbę przy oficerze foryś
orzech|owoc o zdrewniałej łupinie
orzeł|ptak z rodziny sokołów, o masywnej budowie, długich skrzydłach i dużym zakrzywionym dziobie, występuje w wielu gatunkach w Europie, Azji, Ameryce i Afryce|znak w kształcie tego ptaka, używany jako godło lub znak na sztandarach, mundurach, monetach itp.
osa|owad błonkoskrzydły o charakterystycznym czarnym ubarwieniu w żółte paski|osoba uszczypliwa, zjadliwa, dokuczliwa
osioł|gatunek ssaka z rodziny koniowatych, używany jako zwierzę pociągowe i juczne|potocznie: człowiek uparty i głupi, zły uczeń
osoba|człowiek, postać|postać literacka występująca zwłaszcza w utworze dramatycznym
ostry|o przedmiotach: taki, który ma wyostrzoną, tnącą krawędź|o potrawach: mający mocny, piekący smak
oszołomiony|wywrzeć na kimś bardzo silne wrażenie, zwłaszcza pozytywne oczarować|pozbawić kogoś świadomości na pewien czas odurzyć
otchłań|głęboka przepaść|ogromne, głębokie miejsce, zwykle niebezpieczne
otwarty|uczynić wnętrze czegoś dostępnym z zewnątrz
owad|przedstawiciel gromady stawonogów charakteryzującej się ciałem złożonym z segmentów (głowa, tułów i odwłok)
owalny|mający kształt owalu, elipsy, podłużny i zaokrąglony elipsowaty
owca|ssak z rodziny pustorożców
owieczka|młoda owca, jagnię|przenośnie o ludziach kierowanych przez kogoś
owoc|występujący u roślin okrytozalążkowych wytwór zalążni słupka kwiatowego|przen. rezultat, wynik, skutek
owsianka|potrawa przygotowana z płatków owsianych|słoma z wymłóconego owsa
ołówek|przyrząd do pisania z wkładem grafitowym|obrazek narysowany ołówkiem technika jego wykonania
ośmiokąt|wielokąt płaski o ośmiu bokach ośmiobok, oktagon
ośmiornica|ośmioramienny morski głowonóg
pacha|wgłębienie między górną, wewnętrzną częścią ręki a bokiem klatki piersiowej, występujące u ludzi i niektórych ssaków|2.|a) otwór na ramię w ubraniu|b) część ubrania znajdująca się w miejscu pachy anatomicznej
pacyfikator|osoba, która bierze udział w pacyfikacji, używa siły zbrojnej do stłumienia buntów, powstań narodowych
pająk|drapieżny stawonóg z gromady pajęczaków, mający osiem nóg, gruczoł jadowy i żywiący się głównie owadami np. tarantula, ptasznik|stroik ludowy wykonany ze słomy i bibuły, wieszany pod sufitem
palec|jeden z najczęściej pięciu członków zakańczających dłoń, stopy człowieka lub kończyny u zwierząt|część rękawicy okrywająca palec
palenie|podtrzymywać ogień|oświetlać
palić|podtrzymywać ogień|oświetlać
palma|drzewo tropikalne|gałązka przystrojona kwiatami, święcona w kościele katolickim w Palmową Niedzielę
papier|materiał wytwarzany z włókien roślinnych służący różnym celom także: arkusz takiego materiału|potocznie (zwykle w liczbie mnogiej): różnego rodzaju pisma, dokumenty, świadectwa, podania itp.
paproć|roślina o charakterystycznych, pierzastych liściach z kupkami zarodni na spodniej stronie, rosnąca w lasach, a dziś także uprawiana w doniczkach
papuga|egzotyczny ptak charakteryzujący się barwnym upierzeniem i specyficznym hakowato zakrzywionym dziobem|obraźliwe bądź żartobliwe określenie na osobę powtarzającą coś bezmyślnie
parada|uroczysta ceremonia|w sporcie efektowna zasłona ciała, piłki, bramki etc.
parasol|osłona z tkaniny rozpiętej na składanych drutach przymocowanych do pręta, chroniąca przed deszczem lub słońcem|w lotnictwie: jednopłat, którego płat nośny umieszczony jest nad kadłubem
parowy|poruszający się dzięki parze wodnej, napędzany przez parę wodną (np. maszyna parowa)|przestarzale: stanowiący parę
paryż|stolica Francji
pas|w grze w karty: oświadczenie, że się chwilowo rezygnuje z dalszej licytacji lub gry|przenośnie: rezygnacja z dalszego udziału w czymś
pastel|farba artystyczna w postaci miękkiej kredki, wykonanej z barwnika z dodatkiem kredy glinki lub gipsu|technika malowania taką farbą lub obraz, rysunek wykonany taką farbą
patrioci|osoba przywiązana do swojej ojczyzny, kochająca ją i naród, jednocześnie łącząca te uczucia z szacunkiem dla innych narodów
paznokieć|lekko wypukła, zrogowaciała płytka na końcu każdego palca rąk i nóg u człowieka i innych naczelnych|wyróżniająca się, znacznie zwężona dolna część płatków korony niektórych kwiatów
pazur|u zwierząt: zgrubiały wytwór skórny na końcach palców|potocznie: paznokieć
pałac|reprezentacyjna budowla mieszkalna niemająca charakteru obronnego, będąca siedzibą rodziny królewskiej, rodu magnackiego itp. później także reprezentacyjny budynek - siedziba władz, urzędu, instytucji społecznej lub kulturalnej * forma dopełniacza l.poj. "pałaca" możliwa tylko w powiedzeniu "wart Pac pałaca, (a pałac Paca)" - jeden wart drugiego
pchać|posuwać, przesuwać|przen. namawiać do czegoś o czymś: pociągać
pchła|drobny owad o ciele bocznie spłaszczonym, narządzie gębowym kłująco-ssącym
pedał|część niektórych urządzeń mechanicznych|żartobliwie, metaforycznie o nogach
pegaz|symbol natchnienia poetyckiego w postaci skrzydlatego konia|bajeczny koń skrzydlaty z głową gryfa hipogryf
peleryna|rodzaj okrycia przeciwdeszczowego bez rękawów|niewielki fragment ozdobnej tkaniny zawieszanej przy kołnierzu
perfumy|kosmetyk w płynie dla kobiet i mężczyzn, zawierający kompozycję odpowiednio dobranych substancji zapachowych - naturalnych bądź sztucznych
perkusista|muzyk grający na instrumentach perkusyjnych
peruka|sztuczne lub naturalne włosy przymocowane do specjalnej siatki, układane w kształcie fryzury, nakładane na własne włosy lub zastępujące je|narośl kostna spotykana zamiast poroża na głowie kozła lub byka jelenia
perła|kulisty, srebrzystoszary twór ceniony w jubilerstwie, wytwarzany przez wiele gatunków mięczaków, zwłaszcza perłopławów|potocznie o czymś cennym, niepospolitym, wyróżniającym się
pełzaki|gatunek z podgromady korzenionóżek, należący do najprostszego rzędu pierwotniaków o zmiennym kształcie ciała ameba
piasek|szarawożółte ziarenka skalne pokrywające plaże, pustynie, wydmy itp.|(zwykle w lm: piaski) teren, ziemia piaszczysta
piaskownica|niewielki teren pokryty piaskiem, przeznaczony do zabaw dla dzieci|bylina z rodziny traw, o zielonkawych liściach pokrytych meszkiem, najczęściej spotykana na wydmach
piec|poddawać produkt żywnościowy działaniu ognia (wysokiej temperatury w piekarniku)|parzyć, palić, doskwierać
pieczenie|upieczone lub ugotowane, uduszone mięso w jednym kawałku, najczęściej podawane razem z sosem powstałym przy przyrządzaniu tego mięsa
pieczeń|upieczone lub ugotowane, uduszone mięso w jednym kawałku, najczęściej podawane razem z sosem powstałym przy przyrządzaniu tego mięsa
piekarnik|wbudowane w trzon kuchenny lub wolno stojące domowe urządzenie do pieczenia, głównie ciast i potraw mięsnych
pielucha|niegdyś niewielki kawałek płótna lub podobnego materiału, dziś specjalny rodzaj jednorazowej bielizny służącej do przewijania, najczęściej niemowląt
pielęgniarka|pracownica służby zdrowia uprawniona do pomocy w pielęgnowaniu chorych i wykonywania podstawowych zabiegów leczniczych
pieniądze|powszechnie akceptowany środek wymiany
pieprz|niski krzew z rodziny pieprzowatych uprawiany w krajach tropikalnych i subtropikalnych oraz owoc takiego krzewu, najczęściej suszony, stosowany jako przyprawa stołowa
pierdnięcie|potoczne: wypuścić gazy zbierające się w organizmie
pierwszy|liczebnik porządkowy odpowiadający liczbie |stojący na początku
pierścień|obrączka, najczęściej ze szlachetnego metalu, często przyozdabiana szlachetnymi kamieniami, pełniąca funkcję ozdoby lub oznaki godności|coś w kształcie okręgu, głównie część jakiejś maszyny, słój na pniach drzew lub zespół oddzielnych przedmiotów tworzących krąg
pies|zwierzę domowe występujące w wielu rasach, tresowane dla różnych celów|wyzwisko
pigułka|sproszkowany lek zmieszany z masą spoistą, uformowany w małą, twardą kulkę|kulka ulepiona z miękkiej masy, np. z ciasta, ze śniegu
pijany|mieć w zwyczaju picie jakiegoś napoju, np. ziół, kawy, alkoholu, co jakiś czas
piknik|zabawa towarzyska na wolnym powietrzu poza miastem wycieczka majówka
pinceta|rodzaj szczypiec o sprężystych ramionach pęseta
pingwin|ptak o krótkich nogach i skrzydłach oraz czarno-białym upierzeniu, nielatający, lecz świetnie pływający, żyjący w wielkich koloniach, głównie na Antarktydzie bezlotek|w gwarze młodzieżowej: zakonnica batman
pingwiny|ptak o krótkich nogach i skrzydłach oraz czarno-białym upierzeniu, nielatający, lecz świetnie pływający, żyjący w wielkich koloniach, głównie na Antarktydzie bezlotek|w gwarze młodzieżowej: zakonnica batman
pionowy|tworzący z podstawą kąt prosty, prostopadły do podstawy usytuowanej poziomo lub poruszający się, działający prosto w dół lub w górę
piosenka|krótki, prosty utwór muzyczny z tekstem do śpiewania
piosenkarz|wykonawca piosenek, pieśni, najczęściej będący także ich kompozytorem, autorem pieśniarz
piramida|monumentalna budowla w kształcie ostrosłupa o kwadratowej podstawie, budowana w starożytnym Egipcie jako grobowiec dla faraona, także: bryła geometryczna o takim kształcie|rodzaj grupowego ćwiczenia akrobatycznego, w którym akrobaci tworzą coś w rodzaju pionowo stojącego trójkąta
pirat|korsarz morski|osoba pobierająca profity z tytułu nieautoryzowanej sprzedaży cudzej własności intelektualnej
pisanie|tworzyć tekst na jakiejś powierzchni używając do tego stosownego narzędzia|donosić, przekazywać coś na piśmie lub w druku, komunikować o czymś w taki sposób
pistolet|krótka, ręczna broń palna, przeznaczona do strzelania na bliskie odległości, początkowo działająca na zasadzie odrzutu zamka swobodnego, później zmodernizowana do broni samopowtarzalnej wykorzystującej krótki odrzut lufy|urządzenie wyrzucające pod ciśnieniem farbę, lakier lub wodę
piwo|napój z niewielką zawartością alkoholu, otrzymany ze słodu jęczmiennego, chmielu, drożdży i wody, a także: jedna butelka, porcja tego napoju
pióro|wytwór skóry u ptaków|przedmiot, narzędzie podobne do ptasiego pióra
piątka|cyfra oznaczająca liczbę pięć |pięć osób
piętro|kondygnacja budynku nad parterem lub nad inną kondygnacją|strefa znajdująca się na określonej wysokości nad poziomem morza, w której panuje pewien typ roślinności
pięść|zaciśnięta dłoń
piła|narzędzie do przecinania pilarka|potocznie: człowiek natarczywy, nudny, pedantyczny
piłka|napełniona powietrzem kula odbijająca się sprężyście, najczęściej wykonana z gumy lub skóry, wykorzystywana do zabawy lub gier sportowych |niewielka piła ręczna
piżama|strój przeznaczony do spania lub odpoczynku, składający się z luźnych spodni i bluzy albo spodenek i koszulki pidżama pyjama (rzadko)
plac|duża, wolna przestrzeń w mieście, zwykle otoczona budynkami|teren przeznaczony pod zabudowę, otaczający zabudowę
plakat|duży arkusz papieru zawierający informację w formie graficznej
plama|część jakiejś powierzchni wyróżniająca się inną barwą, często szpecąca, o nieokreślonym kształcie|hańba, niesława, wpadka
planeta|ciało niebieskie krążące wokół macierzystej gwiazdy
plaża|pas wybrzeża przy zbiorniku wodnym pokryty piaskiem lub żwirem
plecak|torba przystosowana do noszenia na plecach
pluton|pierwiastek chemiczny o symbolu Pu|pododdział wojskowy składający się zwykle z kilkudziesięciu ludzi
pluć|wyrzucać z ust, np. ślinę|przenośnie: wymyślać komuś, znieważać kogoś
pocałunek|pocałowanie kogoś dotkniecie kogoś ustami buziak, całus
pochodnia|smolne łuczywo lub osadzone na szczapie skręcone pakuły nasycone smołą, używane dawniej do oświetlania|zjawisko występujące na słońcu w postaci okresowo pojawiających się miejsc jaśniejszych
pocisk|ciało wystrzeliwane z broni miotającej
pociąg|zespół sprzęgniętych ze sobą pojazdów kolejowych poruszający sie po szynach, ciągnięty przez lokomotywę|skłonność do czegoś upodobanie
poczta|instytucja zajmująca się dostarczaniem korespondencji, placówka tej instytucji|korespondencja
pod|przyimek łączący się z rzeczownikami (lub wyrazami o ich funkcji) w bierniku lub narzędniku * forma "pode" możliwa tylko w kilku tradycyjnych połączeniach (np. pode mną, pode mnie, pode drzwiami)
podejrzeć|przyjrzeć się ukradkiem, niepostrzeżenie, w chwili, gdy ktoś nie chce być widziany podpatrzyć
podkoszulek|krótka męska koszulka bez rękawów noszona na gołe ciało
podołek|wgłębienie w fartuchu lub sukni tworzące się z wypukłości materiału podczas siadania
podróż|przebywanie drogi do odległego miejsca przemierzanie rozległych terenów podróżowanie
pogrzeb|pogrzebać, pochować zmarłego
pojedynek|dawny sposób rozstrzygania porów i załatwiania zatargów honorowych przez walkę dwóch przeciwników według ściśle ustalonych reguł|walka dwóch rycerzy|4. w sporcie: walka dwu przeciwników
pokrywa|kłaść jakiś materiał na powierzchnię czegoś i przyszywać dookoła na stałe obszywać, obijać|nakładać na powierzchnię czegoś cienką warstwę, np. farby
pokój|pomieszczenie w mieszkaniu lub innym lokalu, przeznaczone do spędzania w nim określonych pór dnia i nocy|zgoda między stronami, które nie są ze sobą w konflikcie rozejm
pole|teren przeznaczony pod uprawę|powierzchnia danej figury wyrażona liczbą
policja|służba mundurowa mająca na celu utrzymanie porządku, dopilnowanie przestrzegania prawa oraz ściganie przestępców
policzek|boczna część twarzy między okiem, nosem, uchem a brodą regionalnie: polik, jagoda|uderzenie otwartą dłonią w twarz
policzkować|bić po twarzy
pomadka|kosmetyk do malowania ust szminka|cukierek z miękkiej masy mlecznej lub czekoladowej
pomarańczowy|dotyczący pomarańczy (drzewa)|odnoszący się do owoców pomarańczy, zrobiony z pomarańczy, mający smak pomarańczy, zapach pomarańczy
pomidor|gatunek jednorocznej rośliny warzywnej
pomysł|koncepcja, plan, projekt jakiegoś działania lub rozwiązania czegoś
ponton|gumowa, nadmuchiwana łódka
popiół|stała pozostałość po spaleniu substancji organicznej, np. paliw stałych lub płynnych, czy masy organizmów żywych|o czymś, co przestało istnieć
poroża|rozgałęzione rogi występujące u samców ssaków z rodziny jeleniowatych
port|miejsce postoju i obsługi statków|miasto portowe
portfel|kieszonkowa torebka z przegródkami, służąca do przechowywania pieniędzy i dokumentów pulares pugilares|ogół papierów wartościowych i innych aktywów inwestora portfolio
posiłek|książkowo:|pożywienie jedzone dla zaspokojenia głodu, posilenia się|jedzenie czegoś
poszukiwacze|osoba prowadząca działania w celu odnalezienia lub pozyskania kogoś lub czegoś|naukowiec prowadzący badania w celu odkrycia lub odnalezienia czegoś nieznanego lub ukrytego
potwór|istota brzydka, o kształtach odmiennych od powszechnie spotykanych w naturze, odrażająca monstrum straszydło|człowiek pozbawiony ludzkich uczuć okrutnik
powieść|dłuższy utwór epicki pisany prozą, o wielowątkowej fabule
powódź|przejściowe zjawisko hydrologiczne polegające na wezbraniu wód rzecznych lub morskich w ciekach wodnych, zbiornikach lub na morzu powodujące po przekroczeniu przez wodę stanu brzegowego zatopienie znacznych obszarów lądu
poza|postawa, układ postaci, ułożenie ciała|sztuczne zachowanie, przesada w zachowaniu, maniera, nienaturalność
pozytywka|urządzenie mechaniczne grające po nakręceniu jakąś melodię, umieszczane w zegarach, puzderkach, zabawkach
południe|środkowa pora dnia|jedna z czterech stron świata
pościel|ułożyć pościel, przygotować łóżko do spania
pośpiech|szybkie, prędkie działanie, śpieszenie się
pożar|niekontrolowane, samoczynne rozprzestrzenianie się ognia, stwarzające zagrożenie dla zdrowia lub życia ludzi
praca|świadoma, celowa działalność człowieka służąca zaspokajaniu potrzeb lub polegająca na wytwarzaniu dóbr, wykonywaniu czynności za wynagrodzenie|dzieło, wytwór takiej działalności
prawnik|osoba działająca zawodowo w obszarze prawa|potocznie o studencie prawa
precel|obwarzanek w kształcie ósemki
prochowiec|rodzaj płaszcza
prom|statek wodny przeznaczony do przewozu między dwoma odcinkami drogi lądowej, rozdzielonymi rzeką, kanałem, akwenem morskim itp.
proste|równy, niewykrzywiający się, nieskręcony w żadną stronę|niewykształcony, nieoczytany, mało rozwinięty kulturalnie i intelektualnie
proszek|zdrobnienie od: proch
pryszcz|ropny wykwit na skórze w postaci pęcherzyka wypełnionego płynem surowiczym lub ropnym, powstający zwykle z gruczołów łojowych krosta|potocznie: coś łatwego lub nieistotnego, bez znaczenia drobiazg, drobnostka, głupstwo
prysznic|natrysk|urządzenie, w którym strumień wody rozpryskuje się, przepływając przez specjalne sito|kąpiel pod takim urządzeniem tusz
pryzmat|w geometrii: graniastosłup o podstawie trójkątnej|bryła z przezroczystego materiału o takim kształcie, służąca do odbijania, załamywania lub rozszczepiania światła
przechodzić|spędzić pewien czas na chodzeniu
przejazdy|przebywanie jakiejś drogi pojazdem|miejsce, gdzie można przejechać w poprzek jakąś trasę, drogę, zwłaszcza tor kolejowy
przekładnie|urządzenie przenoszące ruch obrotowy z jednego wału na drugi|rodzaj odstępstwa od zwykłego szyku w zdaniu, polegający na rozdzieleniu wyrazów tworzących związki składniowe z innymi wyrazami
przepraszam|poprosić o przebaczenie, tłumacząc się i usprawiedliwiając prosić o darowanie winy
przewody|rura lub kanał w urządzeniach wentylacyjnych albo wodociągowych|drut, po którym przepływa energia elektryczna
przełącznik|przyrząd do włączenia lub wyłączenia jakiegoś urządzenie lub obwodu elektrycznego|rodzaj koncentratora sieci teleinformatycznej, umożliwiający podłączenie do niej wielu urządzeń switch
przybornik|zestaw przyborów do czegoś
przybory|nazwisko, np. Jeremi Przybora (1915-2004), poeta
przyjaciel|człowiek pozostający z kimś w bliskich, zażyłych stosunkach powiernik, druh|człowiek okazujący sympatię, poparcie zwolennik, protektor, miłośnik
przynęta|pokarm pozostawiany w celu zwabienia ryb, zwierzyny lub ptaków zanęta
próg|poprzeczna dolna część futryny drzwiowej, wystająca nad poziom podłogi
pszczoła|owad, żyjący w rojach, hodowany ze względu na miód i wosk
pszenica|roślina roczna z rodziny traw, jedno z najpopularniejszych zbóż uprawiane na wszystkich kontynentach|ziarno tej rośliny
ptak|przedstawiciel gromady kręgowców stałocieplnych z grupy owodniowców, charakteryzujących się jajorodnością, ciałem pokrytym piórami, kończynami przednimi przekształconymi w skrzydła, szczękami bezzębnymi, okrytymi rogowym dziobem
publiczność|grupa ludzi, z których większość bywa niezwiązana ze sobą, zgromadzona gdzieś w jakimś określonym celu publika
puchar|duże, ozdobne naczynie, najczęściej w postaci głębokiej czary lub kielicha nakrywanego pokrywą, dawniej służące do picia wina, obecnie wręczane jako rodzaj nagrody honorowej
pudel|rasa psa domowego o długiej sierści, kojarzona ze względu na charakterystyczne uczesanie (wygala się go na łyso przy szyi, uszach i ogonie)
pudełko|skrzynka z lekkiego materiału, zwykle służąca do przechowywania czegoś
pukanie|uderzać w coś lekko, powodując powstawanie jakiegoś odgłosu stukać, kołatać|potocznie: strzelać
pusty|niepełny, niczym nie napełniony, nic nie zawierający, często w znaczeniu: bezludny, opustoszały, przez nikogo ani przez nic nie zamieszkały|cechujący się lekkomyślnością, beztroskim usposobieniem (np. pusty śmiech)
pustynia|obszar pozbawiony widocznych przejawów życia lub o bardzo ubogiej, rzadkiej szacie roślinnej, najczęściej bez dostępu do większych ilości wód użytkowych|potocznie o pustkowiu, pustce, miejscu cichym, odludnym
puzon|instrument muzyczny trombon
pułapka|potrzask, urządzenie służące do chwytania drapieżników, najczęściej używane przez myśliwych, a także: zasadzka, podstęp
półka|deska do układania na niej książek, ubrań, zabawek itp.|wąskie wgłębienie wzdłuż skały
północ|godzina dwunasta w nocy|jedna z czterech stron świata
pączek|zawiązek pędu liścia lub kwiatu, zwykle ochraniany przez twardawe łuski|nadziewane i smażone na tłuszczu ciastko, najczęściej kuliste i słodkie
pęcherzyki|niewielki pęcherz (twór na ciele powstały w wyniku poparzeń lub odciśnięć skóry)|niewielki pęcherz (narząd pełniący funkcję magazynu w ciele niektórych zwierząt) niewielka bańka gazowa, najczęściej tworząca się w cieczach i stopniowo unosząca się do warstw o niższej gęstości
pęknięcie|widoczne miejsce, najczęściej w postaci rysy, szczeliny na płaskiej powierzchni, spowodowane uszkodzeniem mechanicznym
pętla|kawałek sznura lub innego podobnego materiału, związany w pierścień, używany do różnych celów, najczęściej jako pułapka zastawiana przez kłusowników lub żeglarski węzeł ratowniczy|fragment toru ruchu czegoś, o kształcie zbliżonym do okręgu
płakać|wylewać, ronić łzy, najczęściej przez zdenerwowanie, wzruszenie lub ból, a także: narzekać z płaczem na coś lub na kogoś, żalić się
płaszcz|rodzaj wierzchniego okrycia z długimi rękawami, szytego według przeróżnych fasonów|izolacyjna, ochronna warstwa nakładana na maszyny lub urządzenia techniczne
płatek|płateczek, niewielki płat (płaski, cienki kawałek czegoś), plasterek|listek korony kwiatowej jakiejś rośliny, najczęściej barwny i delikatny
płetwa|część ciała ryby służąca do poruszania się i sterowania|część oprzyrządowania nurka służąca do poruszania się pod wodą
płot|rodzaj ogrodzenia parkan * forma dopełniacza l.poj. "płota" możliwa tylko w przysłowiu "Słowo się rzekło, kobyłka u płota"
płuco|parzysty narząd oddechowy kręgowców oddychających powietrzem atmosferycznym
płytki|mający małą głębokość|powierzchowny, niemający skłonności do zastanawiania się nieprzemyślany
pływanie|poruszać się w wodzie, po wodzie lub innym płynie   mieć cechy, które uniemożliwiają zatonięcie w wodzie
pływać|poruszać się w wodzie, po wodzie lub innym płynie   mieć cechy, które uniemożliwiają zatonięcie w wodzie
rachunek|dokonywanie działań, obliczeń|kwota należności także: dokument, papier z tą kwotą
radość|uczucie zadowolenia, wesołości wesoły nastrój rozradowanie
rakieta|obiekt latający silnikiem odrzutowym |przedmiot służący do odbijania piłki, np. w tenisie lub badmintonie paletka
rama|obramowanie o kształcie np. prostokąta, służące jako oprawa czegoś, np. zdjęcia|przyrząd do napinania, mocowania czegoś element jakiegoś urządzenia o takim zastosowaniu
ramię|pierwsza część ręki, od łopatki do łokcia, składająca się z kości ramiennej, mięśnia dwu- i trójgłowego ramienia|staw łączący łopatkę z barkiem
rampa|pomost do przeładunku, np. w kopalni|przednie oświetlenie sceny teatralnej złożone z dwóch rzędów, jednego wzdłuż dolnej linii portalu scenicznego i drugiego wzdłuż górnej
rana|uszkodzenie ciała związane z przerwaniem tkanek
ranek|początek dnia rozpoczynający się wraz ze wschodem słońca poranek, świt
recykling|proces odzyskiwania z odpadów substancji, które mogą być powtórnie wykorzystane jako surowce (dotyczy to głównie papieru, szkła, metalu i niektórych tworzyw sztucznych) recycling, recyklizacja
rekin|drapieżna ryba morska|osoba rozporządzająca dużymi środkami materialnymi
rekord|najlepszy wynik największe osiągnięcie w jakiejś dziedzinie|w bazach danych: pojedynczy wpis do bazy
renifer|zwierzę z rodziny jeleniowatych, żyjące w krajach północnych Europy, Azji i Ameryki ren
robak|w zoologii: przestarzałe określenie pasożytniczych bezkręgowców o wydłużonym ciele|potocznie: dżdżownica, gąsienica, larwa lub owad
rocznik|zbiór wszystkich numerów jakiegoś wydawnictwa wydanych w przeciągu jednego roku|publikacja ukazująca się raz w roku
rodzice|ojciec i matka
rodzina|podstawowa grupa społeczna, składa się z rodziców i ich dzieci, cechuje ich więź formalna, wspólnota materialna, mieszkaniowa oraz określony zespół funkcji.
rolka|wałek lub szpula, na które się coś nawija
rolnik|osoba prowadząca gospodarstwo rolne, pracująca na roli|osoba mająca ukończone studia rolnicze
ropucha|lądowy płaz bezogonowy, podobny do żaby lecz większy, pokryty chropowatą skórą z licznymi gruczołami, często jadowymi|pogardliwie o kimś brzydkim
rosja|państwo w Europie i Azji ze stolicą w Moskwie Federacja Rosyjska
rower|pojazd dwukołowy napędzany energią człowieka
rozgwiazda|morski szkarłupień o ciele w kształcie pięcio- lub wieloramiennej gwiazdy
rozwód|sądowne rozwiązanie związku małżeńskiego na żądanie jednego lub obojga małżonków
roślina|organizm żywy, pobierający pokarm w postaci prostych związków nieorganicznych (rośliny samożywne) lub związków organicznych (rośliny cudzożywne) z martwego podłoża
rtęć|pierwiastek chemiczny o symbolu Hg
rubin|minerał, czerwona odmiana korundu, cenny kamień szlachetny|kolor ciemnoczerwony
rudowłosy|mający rude włosy ryżowłosy, miedzianowłosy, ognistowłosy, czerwonowłosy
rufa|tył statku, okrętu, łodzi
rumieniec|inaczej pąs, intensywny czerwony kolor
rura|przewód o przekroju pierścieniowym używany zwykle do transportu cieczy i gazów|przestarzale:|a) kość długa ze szpikiem|b) lufa broni palnej
ryba|przedstawiciel gromady obejmującej około 20 tys. gatunków zmiennocieplnych kręgowców wodnych, przystosowanych do życia w wodzie (m.in. oddychanie skrzelami, kończyny w postaci płetw)
ryzyko|niebezpieczeństwo, że coś zdarzy się w inny od oczekiwanego sposób "dobrze skalkulowana niepewność"|działanie związane z niebezpieczeństwem także podejmowanie takich działań ryzykowanie
ryż|roślina zbożowa rosnąca na ciepłych obszarach wszystkich części świata, uprawiana w wielu gatunkach dla ziarna a także rosnąca dziko,|ziarno tej rośliny lub potrawy przyrządzane z tych ziaren
rzeka|naturalny, większy ciek wodny powstały z połączenia potoków lub wypływający z jeziora, źródła lub mokradła, płynący stale lub okresowo, wpływający do morza, innej rzeki lub jeziora|przen. coś poruszające się dużym strumieniem
rzep|rodzaj zapięcia
rzepka|mała, spłaszczona kość wchodząca w skład stawu kolanowego, chroniąca kolano przed urazami|mała rzepa
rzeźnik|osoba zajmująca się ubojem zwierząt|osoba sprzedająca mięso i wędliny
rzucać|wprawiać rzecz w lot wypuszczając ją z ręki z nadaniem pewnej prędkości|przewracać, zwalać, uderzać gwałtownie poruszać, potrząsać
rzygać|potocznie:|zwracać zawartość żołądka wymiotować|gwałtownie wyrzucać coś z siebie bluzgać, buchać czymś
rząd|zbiór elementów ułożonych obok siebie poziomo szereg|jednostka w systematyce organizmów żywych
rzęsa|(zwykle w lm - rzęsy) krótki, sztywny włosek wyrastający na brzegu powieki, osłaniający oko przed ciałami obcymi|pływająca roślina wodna
róg|wyrostek u zwierząt lub bezkręgowców|substancja tworząca rogi zwierzęce
róża|roślina z rodziny różowatych kwiat tej rośliny|choroba zakaźna, której objawem jest ograniczone zapalenie skóry (bolesna czerwona plama)
różowy|mający kolor czerwony z dużą domieszką koloru białego, czerwonawy
ręka|kończyna górna człowieka i naczelnych
rękawica|część ubioru chroniąca dłoń, np. przed zimnem lub wysoką temperaturą rękawiczka
rękawice|część ubioru chroniąca dłoń, np. przed zimnem lub wysoką temperaturą rękawiczka
sam|sklep samoobsługowy
samochód|pojazd lądowy, czterokołowy używany do przewozu ludzi i towarów
samolot|maszyna latająca z skrzydłami o jednym do trzech płatów (par skrzydeł) służy jako transport lub jako maszyna bojowa
sandały|but składający się z podeszwy i pasków lub rzemyków
saneczkarstwie|dyscyplina sportowa
sanie|pojazd zaprzęgany w konie, w krajach północnych w reny lub psy, poruszający się po śniegu|urządzenie na płozach służące do przemieszczania jachtu na wodę
sanki|pojazd na płozach używany głównie przez dzieci do zjeżdżania z pagórków, a także przez sportowców w zawodach saneczkarskich
sałatka|potrawa z drobno pokrojonych warzyw, owoców, mięs, ryb, jajek itp., serwowana na zimno lub na ciepło|niewielka sałata - roślina warzywna o jadalnych liściach
schody|konstrukcja złożona z szeregu stopni, umożliwiająca przejście na inny poziom budynku lub terenu
seler|dwuletnia roślina warzywna z rodziny baldaszkowatych, o pierzastych liściach zawierających olejki eteryczne i zgrubiałym, jadalnym korzeniu|korzeń lub liście tej rośliny
sen|stan fizjologiczny polegający na obniżeniu wrażliwości na bodźce, zwolnieniu funkcji fizjologicznych i zaniku przytomności w celu regeneracji organizmu spanie|obraz widziany podczas spania marzenie senne
ser|produkt spożywczy otrzymywany z mleka
serce|narząd zapewniający krążenie w układzie krwionośnym ssaków i ptaków|przenośnie: siedziba uczuć, szczególnie miłości, źródło cnót i wartości
serwetka|kwadratowy kawałek tkaniny lub bibułki służący do wycierania ust lub ochrony ubrania podczas jedzenia|mała serweta, często haftowana
siedzenie|znajdować się w pozycji siedzącej|pot. przebywać gdzieś przez jakiś czas (np. w szkole, na strychu)
siedzieć|znajdować się w pozycji siedzącej|pot. przebywać gdzieś przez jakiś czas (np. w szkole, na strychu)
silnik|maszyna zamieniająca energię na pracę mechaniczną|w informatyce: silnik gry - główna część kodu danej gry komputerowej, np. Unreal Engine, CryEngine engine
siodło|siedzenie ze skóry i włosia do jazdy wierzchem
siostra|córka tych samych rodziców w stosunku do innej córki lub syna|członkini zakonu żeńskiego
siła|energia fizyczna lub duchowa moc|zdolność oddziaływania, wywierania wpływu
skakanka|sznur z uchwytami służący do ćwiczeń sportowych albo jako zabawka dla dzieci
skala|usystematyzowane zestawienie wartości danej wielkości|przen. wielkość, poziom
skarpetka|trykotowe okrycie stopy do kostki, często również powyżej niej (niekiedy do kolan) skarpeta
skarpety|trykotowe okrycie stopy do kostki, często również powyżej niej (niekiedy do kolan) skarpetka
skała|zespół różnych minerałów, lub jednego, powstały w naturalnych procesach geologicznych lub kosmologicznych|góra kamienna, duży głaz 3 w przenośni o kimś: twardy jak skała
sklepienie|konstrukcja budowlana w kształcie łuku, zamykająca od góry przestrzeń budynku|pozioma belka ograniczająca od góry otwór okienny lub drzwiowy i podtrzymująca mur ponad nim
skok|oderwanie się od podłoża poprzez odbicie się nogami podskok, zeskok|nagła zmiana przeskok
skorpion|bezkręgowiec z gromady pajęczaków
skorupa|twarda warstwa pokrywająca coś z wierzchu, np. skorupa lodowa|kawałek rozbitego naczynia fajansowego, glinianego, porcelanowego
skrzydłowym|przymiotnik od: skrzydło
skrzypce|instrument muzyczny o czterech strunach|grać pierwsze skrzypce - mieć decydujący głos, przewodzić jakiejś grupie
skręcać|zmieniać kierunek drogi|zwijać coś przez kręcenie, plecenie ukręcać, wić
skunks|ssak drapieżny z rodziny łasicowatych, zwierzę znane ze swojego mechanizmu obronnego, polegającego na wystrzykiwaniu cuchnącej cieczy śmierdziel|(zazwyczaj w lm) wyprawiona skórka skunksa i ubrania z niej (np. futro)
skuter|rodzaj pojazdu jednośladowego, przypominającego motor
skóra|zewnętrzna powłoka ciała kręgowców
skórzany|zrobiony ze skóry zwierzęcej (np. pasek skórzany) odnoszący się do przedmiotów ze skóry (np. przemysł skórzany)
smok|stworzenie z legend, bajek itp. przypominające wyglądem wielką jaszczurkę, ziejące ogniem|techn. sito znajdujące się na wlocie przewodu ssawnego pompy, chroniące ją przed zasysaniem dużych zanieczyszczeń kosz ssawny
smutny|ponury, mający zły dzień, nieszczęśliwy, przygnębiony|zasmucający, godny pożałowania
smycz|cienki pas skórzany, z tkaniny skóropodobnej, ewentualnie sznurka służący do prowadzenia zwierząt domowych|pasek, taśma służąca do przenoszenia na szyi drobnych przedmiotów, często z możliwością szybkiego odpięcia
snajper|strzelec wyborowy, uzbrojony w broń umożliwiającą precyzyjne strzelanie do oddalonych pojedynczych celów
sok|płyn wyciśnięty z rozdrobnionych owoców lub warzyw|płyn w organizmach roślinnych, wytwarzany w procesie pobierania dwutlenku węgla z atmosfery
sos|zawiesisty płyn sporządzany jako dodatek do różnych potraw
sosna|światłolubne drzewo lub krzew z rodziny sosnowatych (Pinus), obejmujące około 80 gatunków|drewno tego drzewa sośnina
sowa|ptak z rzędu o tej samej nazwie, charakteryzujący się dużą głową, oczami osadzonymi frontalnie, otoczonymi promieniście ułożonymi piórami, silnie zakrzywionym dziobem i obfitym upierzeniem w Polsce występujący w wielu gatunkach
spacerowicz|osoba lubiąca spacerować, spacerująca
spadek|przemieszczenie się z góry na dół, ruch ciała pod wpływem grawitacji|zmniejszenie wartości
spirala|krzywa okrążająca rozbieżnie (lub zbieżnie) jakiś punkt|przedmiot w kształcie takiej krzywej
splot|wynik splatania|sposób przeplatania nici osnowy i wątku
spocony|spowodować wydzielenie przez kogoś, coś (zwierzę) potu, pokrycie się potem, zwłaszcza przez zmuszenie do wysiłku zgrzać|spocić się - okryć się potem, zgrzać się
spodenki|zdrobnienie od: spodnie
spodnie|znajdujący się na spodzie czegoś, pod spodem czegoś dolny, niższy
sprawiedliwość|uczciwe postępowanie, obiektywne odnoszenie się do rzeczywistości, bezstronność w ocenianiu innych, zgodność z przyjętymi w danej społeczność zasadami etycznymi uczciwość, prawość, obiektywizm|w prawie: organa włądzy sądowniczej sądownictwo, sąd
spłukać|usunąć coś (np. brud) z czegoś za pomocą cieczy obmyć zmyć|spłukać się - potocznie: przegrać wszystko, stracić dużo pieniędzy
stabilny|niezmieniający się przez dłuższy czas stały, nieruchomy|o konstrukcjach lub przedmiotach: utrzymujący stałą pozycję
stadion|odpowiednio wyposażony, otoczony trybunami dla widzów obiekt, na którym odbywają się zawody sportowe|w starożytnej Grecji: jednostka długości równa 164 m (attycka) lub 192 m (olimpijska)
start|rozpoczęcie wyścigu, biegu, pracy, jakiejś działalności|miejsce rozpoczęcia biegu, wyścigu
statek|jednostka pływająca pasażerska lub handlowa|potocznie, zwykle w liczbie mnogiej: sprzęt potrzebny do wykonania jakiejś czynności, narzędzia, przybory, szczególnie naczynia kuchenne
statua|posąg przedstawiający ludzką postać
statyw|stabilna podstawa dla aparatu lub kamery, najczęściej rozstawiana na trzech wysuwanych rurkach (np. statywy przenośne)
stek|kotlet z mięsa wołowego, wieprzowego lub cielęcego steak|końcowy odcinek przewodu pokarmowego z ujściem dróg moczowych i płciowych, występujący u niektórych zwierząt kloaka
stempel|przyrząd służący do odbijania pieczęci, wzoru|znak fabryczny, pieczęć odbite na czymś za pomocą jakiegoś przyrządu
stereofoniczny|przymiotnik od: stereofonia
sterowiec|aerostat z napędem silnikowym
stodoła|budynek, w którym przechowuje się zboże gumno
stopa|najniższa część nogi u człowieka i większości ssaków|część pończochy lub skarpety, którą wkłada się na stopę
stopień|pojedynczy element schodów|występ w jakimś podwyższeniu lub terenie umożliwiający wchodzenie lub schodzenie
stołek|sprzęt domowy, zwykle na czterech nogach, bez oparcia, służący do siedzenia|potocznie: siedzieć na dwu stołkach - być dwulicowym, prowadzić grę na dwa fronty
stożek|figura przestrzenna, na podstawie koła stopniowo zwężająca się ku górze
strach|lęk, obawa, niepokój |kukła, mająca odstraszyć ptaki strach na wróble
strajk|sytuacja gdy pracownicy nie wykonują swojej pracy, żądają określonych zmian np. podwyższenia pensji, zmiany warunków pracy
stromy|prawie prostopadły w stosunku do podłoża pochyły spadzisty
strona|jedna z powierzchni książki, czasopisma, dokumentu, kartki|powierzchnia ograniczająca jakąś bryłę przestrzeń na krawędzi czegoś (np. szosy)
strumień|miasto w Polsce
struś|duży, nielotny ptak o ciemnym upierzeniu występującym na tułowiu i (częściowo) szyi
strzał|moment, w którym z lufy broni palnej wylatuje pocisk wypuszczenie strzały|odgłos wystrzału
strzałka|nazwisko
studentów|osoba, która studiuje (w znaczeniu: pobiera naukę na wyższej uczelni)
stóp|najniższa część nogi u człowieka i większości ssaków|część pończochy lub skarpety, którą wkłada się na stopę
stół|mebel zbudowany z blatu i nóg|rodzaj spożywanych posiłków, np. jarski stół, szwedzki stół, wykwintny stół
sufit|powierzchnia ograniczająca pomieszczenie od góry
sukienka|lekki strój kobiecy, okrywający tułów i część nóg oraz ręce
surfować|[czytaj: serfować] serfować|pływać na desce surfingowej surfingować|spędzać czas, przeglądając strony internetowe
sweter|ubranie wykonane z dzianiny, okrywające tułów i ręce
syn|potomek płci męskiej
syrena|legendarna pół-kobieta, pół-ryba|przyrząd wytwarzający informacyjne lub alarmowe sygnały dźwiękowe
syrop|produkt w przemyśle spożywczym w postaci gęstej, lepkiej, bardzo słodkiej cieczy|lekarstwo otrzymywane przez rozpuszczenie leków w stężonym wodnym roztworze cukru ulepek
szachy|gra prowadzona na szachownicy przez dwóch przeciwników, z których każdy dysponuje szesnastoma figurami (8 pionów, dwa gońce, dwa konie, dwie wieże, hetman i król) komplet figur do tej gry
szafa|mebel mający kształt prostopadłościanu, służący do przechowywania różnych przedmiotów, np. ubrań
szafir|minerał, niebieska przezroczysta odmiana korundu
szalik|mały szal
szampon|płyn do mycia lub farbowania włosów shampoon|płyn do prania dywanów lub mycia karoserii
szata|podniośle: ubranie, strój, ubiór
szczekać|o psie, lisie, szakalu: wydawać krótki, urywany odgłos|potocznie, pogardliwie: obmawiać, oczerniać kogoś szkalować
szczeniak|żartobliwie, pogardliwie o osobie niedorosłej
szczepionka|preparat biologiczny z oczyszczonej zawiesiny zabitych lub unieszkodliwionych bakterii, przeznaczonej do szczepień ochronnych lub leczniczych
szczotka|nazwisko
szczudła|pręt z podpórką na stopę, umożliwiający stawianie kroków bez dotykania ziemi stopą, używany głównie do pokazów, akrobacji|podpora ułatwiająca chodzenie osobom z uszkodzoną lub amputowaną nogą kula
szczur|gryzoń z rodziny myszowatych, zamieszkujący całą kulę ziemską, najbardziej rozpowszechniony: szczur wędrowny|potocznie: płaski rzut piłką, kiedy piłka leci tuż nad ziemią
szczęka|parzysta kość trzewioczaszki, w której osadzone są górne zęby|uchwyt w narzędziach ślusarskich
szczęki|parzysta kość trzewioczaszki, w której osadzone są górne zęby|uchwyt w narzędziach ślusarskich
szept|ciche, bezdźwięczne mówienie, słyszane tylko przez osoby znajdujące się blisko mówiącego|poetycko: cichy dźwięk nieokreślonej wysokości, wydawany przez coś będącego w stałym, jednostajnym ruchu szmer, szelest
szeryf|w USA: lokalny urzędnik egzekwujący prawo|w średniowiecznej Anglii: królewski urzędnik o rozległych kompetencjach obecnie: tytuł honorowy
sześciopak|zgrzewka zawierająca sześć jednostek danego produktu, np. piwa, wody mineralnej
szkielet|mocna, twarda konstrukcja wchodząca w skład żywego organizmu ludzkiego bądź zwierzęcego, zbudowana z substancji organicznej lub nieorganicznej, pełniąca funkcję podporową, ochronną i usztywniającą w stosunku do miękkich części organizmu, np. szkielet ochronny, właściwy układ szkieletowy, układ kostny, kościotrup|system konstrukcyjny budowli lub urządzenia technicznego w postaci przestrzennego układu prętów konstrukcyjnych - sztywno ze sobą połączonych elementów pionowych (słupów) i poziomych (belek), np. szkielet, samolotu, statku rdzeń
szkocja|część składowa Wielkiej Brytanii
szkoła|instytucja oświatowa przekazująca wiedzę oraz podstawowe umiejętności|budynek takiej instytucji
szkło|przezroczysta substancja otrzymywana w wyniku stopienia i oziębienia mieszanki krzemianów|szyba, płyta, tafla ze szkła
szmaragd|odmiana berylu, przezroczysty, zielony minerał będący cennym kamieniem szlachetnym|intensywnie zielony kolor
szmata|kawał tkaniny, zwykle zniszczonej, podartej gałgan|pogardliwie o człowieku mającym słaby charakter także o kobiecie lekkich obyczajów
sztuka|twórczość artystyczna człowieka|utwór dramatyczny przeznaczony do wystawiania na scenie
szuflada|wysuwana część mebla, zwykle w postaci otwartej skrzynki, przeznaczona do przechowywania rzeczy
szum|przeciągły, długi szmer, hałas|zamieszanie, zamęt rozgłos
szwecja|państwo w Europie ze stolicą w Sztokholmie Królestwo Szwecji
szyja|u człowieka i niektórych zwierząt: część ciała łącząca głowę z tułowiem
szynka|mięso wieprzowe (z tylnej części wieprza) wędlina z tego mięsa
szyszka|drewniany kwiatostan żeński roślin iglastych|kwiatostan żeński chmielu
szyć|łączyć nićmi jakiś materiał wytwarzać coś poprzez zszywanie|przelatywać przeszywać powietrze pędzić
sól|związek chemiczny złożony z kationu metalu (ewentualnie amonowego) i anionu reszty kwasowej|zwyczajowa nazwa chlorku sodu, popularnej przyprawy do potraw
sędzia|osoba wydająca sąd|funkcjonariusz publiczny uprawniony do orzekania w sprawach należących do właściwości sądów i trybunałów, na zasadach niezawisłości i bezstronności
słaby|odznaczający się niewielką siłą fizyczną
słodkie|jeden ze smaków
słoik|szklane naczynie do przechowywania wyrobów spożywczych mały słój
słoma|łodygi i liście dojrzałych roślin uprawnych pozostające po wymłóceniu nasion
słoneczny|dotyczący Słońca|wypełniony światłem słońca, nasłoneczniony, niezacieniony
słoń|największy roślinożerny ssak lądowy z rzędu trąbowców|przenośnie o człowieku otyłym, ociężałym, niezgrabnie poruszającym się
słońce|centralne ciało Układu Słonecznego Słońce|światło słoneczne
słupek|zdrobnienie od: słup|żeński organ płciowy u roślin okrytonasiennych
słyszeć|odbierać dźwięki w określonym zakresie (przeważnie poprzez ucho)
taca|płaskie naczynie stołowe wytwarzane z różnych materiałów, umożliwiające przenoszenie większej ilości rzeczy (np. potraw), wykorzystywane też podczas kwestowania
tajwan|wyspa na Oceanie Spokojnym|państwo w Azji (formalnie: prowincja Chin)
talerz|naczynie stołowe także zawartość tego naczynia|biała plama na pośladkach jeleniowatych
talia|komplet kart do gry|u kobiety: zwężająca się część tułowia między żebrami i biodrami pas, stan
taniec|zespół ruchów skoordynowanych z muzyką
tarcza|obronna część uzbrojenia, używana przez piechotę i jazdę od czasów starożytnych do czasu wprowadzenia broni palnej, o różnych kształtach i rozmiarach|tablica z koncentrycznymi kręgami, służąca jako cel do strzelania
tatuaż|trwały znak graficzny wykonany na skórze
taśma|pas z jakiegoś materiału o różnym zastosowaniu|wstęga wisząca wzdłuż linii mety, przerywana przez zwycięzcę biegu
teatr|instytucja, organizacja zajmująca się wystawianiem utworów scenicznych też: zespół ludzi pracujących w tej instytucji|budynek, pomieszczenie przystosowane do wystawiania utworów scenicznych
teczka|rodzaj torby ze skóry lub innych tworzyw|rodzaj okładki, zwykle tekturowej, do przechowywania dokumentów, rękopisów, nut, rysunków
telefon|urządzenie, które służy do prowadzenia rozmów na odległość
tenis|gra rozgrywana na korcie przez dwójkę przeciwników (gra pojedyncza) lub dwie rywalizujące pary (debel), przy użyciu odpowiednich rakiet, służących do przebijania piłeczki nad siatką na pole przeciwnika, przeciwników
tipi|stożkowaty namiot indiański z żerdzi pokrytych skórami, matami lub nieprzemakalnym płótnem
tkanka|zespół komórek w organizmie, o podobnej budowie, takim samym pochodzeniu, pełniących określone funkcje
toaleta|pomieszczenie, w którym można załatwić swoje potrzeby fizjologiczne ubikacja, ustęp|kobiecy strój wieczorowy
tom|pojedynczy egzemplarz książki oddzielnie oprawiona część większego dzieła
tonąć|ginąć przez brak możliwości wypłynięcia z wody i złapania oddechu opadać na dno|zapadać się w coś, zagłębiać się w czymś
topienie|zanurzać coś w cieczy w sposób zapobiegający wynurzeniu|uśmiercać istotę wykorzystującą do oddychania płuca poprzez uniemożliwienie jej wypłynięcia z wody i złapania powietrza
topór|broń sieczna siekiera
torba|opakowanie różnych drobnych rzeczy jego zawartość|worek lub walizeczka do przenoszenia przedmiotów
torpeda|hamulec rowerowy umieszczony w tylnej piaście|typ nadwozia samochodu osobowego o opływowym, wydłużonym kształcie
trampki|płócienny but sportowy na gumowej podeszwie
tratwa|pnie drzew ułożone obok siebie i powiązane linami, spławiane z prądem rzeki|konstrukcja z połączonych ze sobą belek, trzciny itp. służąca do transportu po wodzie
trawa|nazwa niektórych gatunków roślin należących do rodziny o tej samej nazwie, charakteryzujących się długimi, wąskimi liśćmi, pustą wewnątrz łodygą, drobnymi kwiatami liście tych roślin|zbiorowo: rośliny rosnące na łące, w ogrodzie
trener|osoba przygotowująca zawodnika lub drużynę do zawodów, występów
trofeum|dowód odniesionego zwycięstwa|dawniej: łup wojenny, np. w postaci zdobytej broni, zbroi
trojaczki|troje dzieci urodzonych podczas jednego porodu troje zwierząt urodzonych w jednym miocie|podręcznik napisany przez trzech autorów
tron|ozdobny fotel będący honorowym miejscem monarchy lub dostojników kościelnych|książkowo:|a) władza lub godność króla korona|b) osoba panująca, monarcha
trumna|skrzynia z wiekiem, w której składa się ciało zmarłego
trójkąt|wielokąt o trzech kątach|przedmiot mający geometryczny kształt tego wielokąta
trąbka|instrument dęty blaszany
tunel|ograniczony z góry odcinek drogi, przejścia, przelotu
tuńczyk|duża drapieżna ryba
twarz|przednia część głowy ludzkiej, lico|przenośnie: osoba
tydzień|okres 7 dni, najczęściej od poniedziałku do niedzieli
tygrys|największy z żyjących obecnie wielkich kotów o długości ciała do 2 metrów, ogona do 1,1 metra i wadze do 360 kg, drapieżnik o zmiennym ubarwieniu, polujący głównie na zwierzęta kopytne, żyjący 15-17 lat w gęstych zaroślach i górskich lasach, zwykle w pobliżu rzek w krajach południowej, wschodniej i południowo-wschodniej Azji oraz Archipelagu Malajskiego|w czasie drugiej wojny światowej: typ niemieckiego ciężkiego czołgu
tyłek|potocznie: pośladki, siedzenie
tęcza|kolorowy łuk na niebie powstały wskutek załamania światła w kroplach deszczu
ubogi|taki, który jest biedny, nie ma pieniędzy
ucho|narząd słuchu i równowagi|małżowina uszna
uchwyt|coś, za co można się chwycić, złapać dla utrzymania równowagi|część przedmiotu służąca do chwytania go ręką
ucieczka|uciekanie skądś lub przed czymś
udo|część kończyny dolnej między biodrem a kolanem (w przypadku owadów - między krętarzem a golenią)
ul|pomieszczenie dla pszczół|potocznie: więzienie
ulica|pas drogi przeznaczony dla pojazdów i pieszych|przenośnie:|a) przechodnie|b) społeczeństwo
unia|związek dwóch lub więcej państw zawarty w celu osiągnięcia korzyści politycznych lub gospodarczych
uran|pierwiastek chemiczny o symbolu U
uroczy|pełen uroku, wdzięku ujmujący, urzekający, czarujący
urodziny|rocznica dnia, w którym się ktoś urodził
urwis|figlarne dziecko, psotnik
usta|otwór gębowy człowieka|wargi * forma narzędnika "usty" przestarzała, używana głównie w języku literackim
wafel|cienkie, kruche ciastko, zwykle płaskie (do tortów) lub w kształcie stożka (do lodów)
wagi|ciężar ciała|przyrząd do wyznaczania masy ciał
wakacje|okres wolny od zajęć szkolnych ferie
walka|zorganizowane działania militarne wrogich wojsk bitwa, starcie, wojna|zmagania przeciwników, sportowców
wampir|według dawnych wierzeń ludowych: trup wstający z grobu i wysysający krew ludzi śpiących|potocznie: człowiek, który popełnił szereg morderstw na skutek zaburzeń psychicznych, zwykle o podłożu seksualnym
wanna|duże naczynie do kąpieli, ceramiczne lub metalowe
warcaby|gra planszowa dla dwóch osób|komplet pionków w kształcie krążków i planszy (szachownicy) do gry w warcaby
warga|dolny bądź górny fałd skórny, tworzący wspólnie z drugim fałdem ograniczenie otworu jamy ustnej|część korony niektórych typów kwiatów, występująca w parze
wazon|ozdobne naczynie na cięte kwiaty
wdowa|kobieta, której mąż zmarł|w DTP (Desktop Publishing): błąd łamania tekstu polegający na pozostawieniu na początku łamu samotnego wiersza poprzedniego akapitu (ostatniego wiersza akapitu)
welon|kawałek materiału przypinany do kapelusza lub upinany na głowie, najczęściej przezroczysty, będący elementem stroju ślubnego, żałobnego noszony też przez zakonnice i duchownych niektórych wyznań
wenus|przenośnie: piękna kobieta
weterynarz|lekarz leczący zwierzęta, zwłaszcza domowe i hodowlane
wełna|sierść niektórych zwierząt, stanowiąca surowiec włókienniczy
whisky|[czytaj: łyski albo łiski] wytrawna wódka z surowego spirytusu zbożowego, oryginalnie szkocka whiskey
wiadro|naczynie w kształcie walca lekko rozszerzonego u góry, z pałąkiem, o pojemności około 10-12 litrów, zwykle blaszane, służące do przenoszenia lub przechowywania wody, śmieci itp kubeł
wiatr|poziomy ruch powietrza, odbywający się z wyżu do niżu, powstający na skutek nierównomiernego rozkładu ciśnienia
wiatraczek|zdrobnienie od: wiatrak
wiatrak|urządzenie ze śmigami do młócenia zboża|potocznie o wentylatorze ze skrzydłami
wice|potocznie: dowcip, żart, kawał witz
widelec|narzędzie stołowe w kształcie widełek, służące do podnoszenia do ust kawałków jedzenia|każda rozwidlona część maszyny, w szczególności część roweru lub motocykla, w której osadzone jest koło
wideo|video|technika rejestrowania na taśmie magnetycznej obrazu i dźwięku|potocznie: sprzęt służący do rejestrowania w technice o tej samej nazwie
wielbłąd|zwierzę
wielkanoc|obchodzone w pierwszą niedzielę po pierwszej wiosennej pełni księżyca, na pamiątkę Zmartwychwstania Jezusa, najstarsze i najważniejsze święto chrześcijańskie Uroczystość Zmartwychwstania Pańskiego Pascha
wieloryb|wielki ssak wodny występujący w wielu gatunkach w morzach całego świata
wieprzowina|mięso ze świni|potrawa z tego mięsa
wiercić|robić w czymś otwór wiertarką lub innym narzędziem|poszukiwać kopalin lub wody poprzez drążenie otworów w skorupie ziemskiej
wierzba|drzewo lub krzew z rodziny wierzbowatych, występujące w wielu gatunkach
wiewiórka|gryzoń nadrzewny z rodziny wiewiórkowatych|w l. mnogiej (wiewiórki): wyprawione skórki z wiewiórek futro z tych skórek
wieża|wysoka budowla lub konstrukcja dawniej: więzienie w takiej budowli, kara więzienia|figura szachowa
wiking|wojownik skandynawski, członek łupieskich drużyn, podejmujących w VIII-XII wieku wyprawy, głównie do krajów europejskich
wikingowie|wojownik skandynawski, członek łupieskich drużyn, podejmujących w VIII-XII wieku wyprawy, głównie do krajów europejskich
wilk|największy przedstawiciel rodziny psowatych, charakteryzujący się szarożółtą sierścią, masywną budową i uzębieniem typowym dla drapieżców
winda|urządzenie służące do przewozu ludzi lub towarów pomiędzy poziomami dźwig
winnica|plantacja winorośli
wino|napój alkoholowy otrzymywany w wyniku fermentacji alkoholowej miazgi lub soku z winogron (wino gronowe), a także z innych owoców, np. porzeczek, jabłek (wino owocowe)|pik w kartach
winogrona|jagoda winorośli
wioska|mała wieś|mieszkańcy wioski
wiosna|jedna z pór roku
wiosła|długi kij zakończony z jednej lub z obu stron płaskimi łopatami, na które woda działa siłą oporu będącą jednocześnie siłą napędową niewielkiej jednostki pływającej|potocznie o łyżce, zazwyczaj dużej
wiosło|długi kij zakończony z jednej lub z obu stron płaskimi łopatami, na które woda działa siłą oporu będącą jednocześnie siłą napędową niewielkiej jednostki pływającej|potocznie o łyżce, zazwyczaj dużej
wir|szybki ruch obrotowy gazu lub cieczy wokół jakiejś osi, miejsce występowania takiego ruchu|przenośnie: natłok różnych spraw, wydarzeń,
wirus|mikroorganizm nieposiadający budowy komórkowej, pasożytujący w organizmie żywym, wywołujący choroby|złośliwy kod komputerowy doczepiający się do uruchomionych programów, zwykle niszczący dane
witamina|organiczny związek chemiczny niezbędny do prawidłowego przebiegu procesów życiowych zachodzących w organizmie, występujący głównie w pożywieniu, biorący udział w regulacji metabolizmu
witka|długa gałązka wić łoza|aparat ruchu jednokomórkowców wić
wiązanie|umocowywać tworząc węzeł|kojarzyć
więzienie|kara pozbawienia wolności|budynek przeznaczony dla trzymania skazanych przez sąd
wiśnia|drzewo lub krzew z rodziny różowatych (Cerasus), w Polsce występuje dziko w trzech gatunkach|jadalny owoc uprawnej odmiany tej rośliny
wkręt|rodzaj śruby
woda|tlenek wodoru najbardziej rozpowszechniony w przyrodzie związek nieorganiczny
wodonośne|obfitujący w wodę
wodorost|najprostsza samożywna roślina plechowa alga glon|roślina bytująca w środowisku wodnym hydrofit roślina wodna
wojna|zorganizowana walka zbrojna między państwami, narodami lub grupami społecznymi, religijnymi itp., prowadzona dla osiągnięcia zamierzonych celów (np. zagarnięcia obcego terytorium lub obrony własnego) konflikt zbrojny|gra w karty
wojownik|uczestnik walk, żołnierz|dzielna osoba walcząca o jakąś chlubną sprawę
worek|pojemnik z płótna lub plastiku zwykle pozbawiony uchwytów
wosk|substancja używana m.in. do wyrobu świec
woskowina|wydzielina gruczołów skóry przewodu słuchowego chroniąca go przed drobnymi ciałami obcymi
wołowina|mięso z krowy lub z wołu wołowe
wrak|zatopiony lub zniszczony statek|pojazd nie nadający się do użytku
wróżka|wieszczka|kobieta, która przepowiada przyszłość z kart, z ręki, z liczb lub innych znaków wróżbitka, wróżbiarka, kabalarka, kabalistka|postać z baśni mająca moc czynienia czarów czarodziejka
wschód|strona świata, po której ukazuje się wschodzące Słońce |wschodnia część kraju, regionu, itp.
wtorek|drugi dzień tygodnia
wtyczka|przyrząd na końcu przewodu, który wraz z gniazdkiem umożliwia zamknięcie obwodu elektrycznego|osoba skierowana do jakiejś organizacji w celu szpiegowania
wulkan|góra w kształcie stożka z kraterem na szczycie, z którego wydobywa się lawa, gazy wulkaniczne i popioły
wybór|zdecydowanie się na coś|dwie lub więcej możliwości alternatywa
wydajność|ilość czegoś wytworzonego, wyprodukowanego, uzyskanego z czegoś|stosunek między ilością uzyskaną a ilością wydatkowaną w procesie produkcji materialnej
wykres|graficzne przedstawienie danych
wylot|wyruszenie w podróż lotniczą|zakończenie rury
wymiociny|to, czym się wymiotuje rzygowiny
wymię|narząd samic niektórych ssaków, zawierający gruczoły mleczne
wypadek|wydarzenie, fakt|nieszczęście, kraksa
wysoki|rozciągły w pionie, okazałego wzrostu |znajdujący się na dużej wysokości
wyspa|teren ograniczony ze wszystkich stron wodą
wyścigi|szybkościowa konkurencja sportowa
wzgórze|niewysokie wzniesienie terenu o łagodnym stoku wzgórek, pagórek
wóz|czterokołowy pojazd drewniany ciągniony przez konie|potocznie: samochód, autobus, tramwaj * forma dopełniacza l.poj. "woza" możliwa tylko w przysłowiu "Przyszła (przyjdzie) koza do woza." - ktoś prosi (poprosi) o pomoc, którą wcześniej odrzucał
wąsy|zarost u mężczyzn nad górną wargą,|włos czuciowy lub wyrostek skórny na pysku niektórych zwierząt,
wąż|pełzający wydłużony gad lądowy lub wodny,|potocznie: rura lub przewód doprowadzające ciecz lub gaz,
węgiel|pierwiastek chemiczny o symbolu C i liczbie atomowej 6, występujący w naturze w dwóch odmianach: diamentu i grafitu|skała osadowa, powstała z obumarłych części roślin, stosowana jako paliwo
węgorz|drapieżna ryba z rodziny węgorzowatych, o wydłużonym, wężowatym ciele, żyjąca w wodach słodkich, na tarło wędrująca do morza
węzeł|splątane miejsce na sznurku (np. węzeł marynarski) |w wyrażeniu "węzeł gordyjski": problem pozornie trudny do rozwiązania, wymagający sprytu
włosy|owłosienie ludzkiej głowy
włócznia|rodzaj kłującej broni drzewcowej używanej do XVII wieku przez piechotę
włóczęga|człowiek lubiący się włóczyć wagabunda, tramp, obieżyświat, włóczykij
z powrotem|na powrót|w kierunku powrotnym, np.: Chodzić tam i z powrotem.|znowu, na nowo, np.: Wziąć się z powrotem do roboty.
zabawki|rzecz służąca dziecku do zabawy|coś niemającego znaczenia, niesprawiającego trudności błahostka drobnostka głupstwo
zabójca|ten, kto dokonał zabójstwa
zachwyt|uczucie uznania dla kogoś lub czegoś
zachód|zniknięcie Słońca lub innego ciała niebieskiego za horyzontem|jedna z czterech stron świata
zajazd|niewielki hotel przy ruchliwej drodze austeria|egzekucja wyroku przez samych zainteresowanych w prawodawstwie staropolskim
zając|płochliwe zwierzę wielkości kota, poruszające się szybkimi skokami
zakładka|dowolny przedmiot, służący do założenia strony w książce|zagięcie na ubraniu, powstałe przez założenie materiału i zaprasowanie go lub częściowe zaszycie fałda (fałd), zapraska, pliska, plisa
zalążek|żeński element rozmnażania się roślin nasiennych, z którego po zapłodnieniu rozwija się nasienie|początek czegoś
zamek|urządzenie do zamykania i otwierania drzwi, walizek, sejfów itp.|suwak, ekler
zapach|bodziec odbierany przez zmysł węchu |przyjemna woń
zapalniczka|kieszonkowy przyrząd do krzesania ognia
zapaśnik|sportowiec uprawiający zapasy
zapora|przeszkoda uniemożliwiająca przejście na drugą stronę blokada bariera
zarost|owłosienie, najczęściej kojarzone z występowaniem na twarzy jako broda, wąsy
zasłony|kotara|zakrycie czegoś
zatoka|część oceanu, morza lub jeziora wcinająca się w ląd
zatruć|dodać do czegoś trucizny|zanieczyścić środowisko, przyrodę itp.
zatrzasnąć|zamknąć coś gwałtownie (z trzaskiem)
zaćmienie|przyciemnić światło zmniejszyć blask czegoś osłabić pamięć
zboże|roślina uprawna dostarczająca ziarna i słomy
zbroja|okrycie ochronne wojownika, zabezpieczające przed ciosami pancerz osłaniający tułów
zderzak|część pojazdu, mocowana z przodu i z tyłu, mająca łagodzić skutki zderzenia
zegar|urządzenie służące do pomiaru i wskazywania czasu
zegarek|mały zegar, zwłaszcza kieszonkowy lub na rękę
zielony|mający kolor świeżej trawy, szmaragdu, szmaragdowy|o roślinach: taki, który nie osiągnął dojrzałości niedojrzały
ziemia|kula ziemska|wierzchnia warstwa skorupy ziemskiej, grunt, gleba
ziemniak|powszechnie uprawiana roślina z rodziny psiankowatych, o jadalnych bulwach rosnących pod ziemią, pochodząca z terenów południowych Andów|bulwa tej rośliny
ziewać|szeroko otwierać usta wydając charakterystyczny przeciągły odgłos, z powodu senności lub znudzenia
zimno|niska temperatura powietrza pogoda o takiej temperaturze chłód, ziąb|potocznie: skupisko pęcherzyków powstających zwykle w okolicach ust u osób cierpiących na opryszczkę
zimowy|przymiotnik od: zima
zmarszczki|bruzdka na skórze, zwłaszcza twarzy i szyi, będące efektem ruchów mimicznych lub starzenia się|drobna nierówność na jakiejś powierzchni falka, fałdka
zmiażdżyć|zgnieść, skruszyć na miazgę, rozgnieść, rozkruszyć|przenośnie: pokonać kogoś, zdobyć nad kimś całkowitą przewagę zgnieść
znaczek|odznaka noszona na ubraniu|mały znak, stosowany do oznaczenia czegoś
znikać|stawać się niewidocznym |stawać się nieobecnym
zupa|potrawa, najczęściej z wody gotowanej z jarzynami, mięsem, owocami itp., podawana zazwyczaj jako pierwsze danie obiadu
zwierzęta|żywy organizm cudzożywny o ograniczonym wzroście, zwykle mający zdolność do ruchu postępowego ssak (potocznie lub w węższym zakresie)|żartobliwie o człowieku jako przedstawicielu najwyższego gatunku w klasyfikacji zoologicznej
zwycięzca|osoba, która zwyciężyła
zygoty|zapłodniona komórka jajowa
zygzak|motyw geometryczny w postaci linii łamanej gzygzak (potocznie)
ząb|koński ząb - odmiana kukurydzy uprawiana na zieloną paszę
zęby|koński ząb - odmiana kukurydzy uprawiana na zieloną paszę
zło|to, co jest niezgodne z zasadami moralności złe|czyn wyrządzający komuś krzywdę złe
złodziej|człowiek, który dopuścił się kradzieży
złoto|pierwiastek chemiczny o liczbie atomowej 79 i symbolu Au, rzadko występujący w przyrodzie, metal wykorzystywany np. do wyrobu biżuterii, monet|wyrób ze złota (metalu)
łabędź|duży ptak z podrodziny o tej samej nazwie
ładny|taki, który się komuś podoba|potocznie: okazały, pokaźny
łapa|potocznie o ręce|kończyna zwierzęcia, głównie ptaka lub ssaka niemającego kopyt
łaskotać|delikatnie dotykać, pocierać opuszkami palców lub jakimiś przedmiotami, np. piórem, wrażliwych na dotyk miejsc na czyimś ciele, powodując śmiech u tego kogoś gilgotać, gilgać, smyrać|łaskotać się:|a) łaskotać siebie samego|b) łaskotać jeden drugiego
łata|kawałek materiału naszywany lub przymocowywany do ubrania itp. tak, aby zakryć dziurę|plama w innym kolorze niż tło (głównie u zwierząt)
ławka|mebel do siedzenia|stolik z krzesłami w klasie, sali dla uczniów itp.
łańcuch|szereg połączonych ze sobą ogniw, tworzących obiekt mechaniczny |szereg znajdujących się blisko siebie, położonych w jednej linii obiektów, elementów
łokieć|staw łączący ramię z przedramieniem, a także część ręki nad tym stawem po stronie zewnętrznej|dawna jednostka długości równa około 0,457 m
łom|stalowy pręt, drąg służący do wyważania, podważania, rozbijania czegoś|blok skalny
łopata|narzędzie ręczne do kopania lub przesypywania|element maszyny do kopania
łoś|zwierzę z rodziny jeleniowatych
łucznictwo|dyscyplina sportowa
łupież|choroba skóry głowy polegająca na łuszczeniu się powierzchniowej warstwy naskórka|drobne płatki łuszczącego się na głowie naskórka
łysy|o człowieku: częściowo lub całkowicie niemający włosów na głowie|o zwierzęciu: częściowo lub całkowicie niemający sierści
łyżeczka|mała łyżka|zawartość łyżeczki
łyżka|przedmiot do spożywania pokarmów, przede wszystkim płynnych zawartość takiej łyżki|część koparki służąca do czerpania i przenoszenia materiału
łyżwa|(zazwyczaj w lm - łyżwy) metalowa, wąska płoza służąca do jazdy na lodzie
łza|kropla słonawej, wodnistej cieczy wydostającej się z oka głównie w czasie płaczu
łzy|kropla słonawej, wodnistej cieczy wydostającej się z oka głównie w czasie płaczu
łódka|mała łódź|podłużny dekolt w sukniach i bluzkach damskich
łódź|mały statek wodny
łóżeczko|zdrobniale o łóżku
łóżko|mebel przeznaczony do leżenia i spania|potocznie o seksie
ściana|pionowa płaszczyzna oddzielająca dwie powierzchnie, przestrzenie, ograniczająca jakieś wnętrze |bok skalnej groty lub niemal pionowe zbocze
ścieżka|drobny ścieg
ślepy|mężczyzna pozbawiony wzroku ślepiec niewidomy (w użyciu rzeczownika)
ślimak|mięczak o asymetrycznym ciele, z wyodrębnioną głową, nogą i workiem trzewiowym, pokryty śluzem, zwykle osłonięty spiralną muszlą|przedmiot, motyw dekoracyjny lub część urządzenia, którego kształt przypomina muszlę ślimaka
śliniaczek|zdrobnienie od: śliniak (kawałek materiału lub plastiku zakładany małym dzieciom pod brodą, aby nie pobrudziły się podczas jedzenia)
śliwka|owoc śliwy
ślub|zawarcie związku małżeńskiego przed duchownym lub urzędnikiem stanu cywilnego,|przest.: ślubowanie uroczysta przysięga, zobowiązanie
śmiech|dźwięki wydawane przez człowieka, który śmieje się, jest rozbawiony|wyśmiewanie się
śmieci|zaśmiecać, brudzić, zanieczyszczać
śmierć|zakończenie funkcji życiowych organizmu
śnieg|rodzaj opadu atmosferycznego, składający się z kryształków zamrożonej wody
śnić|widzieć coś we śnie|marzyć o czymś
śpiewać|używać strun głosowych celem wyprodukowania dźwięków nazywanych śpiewem
świeca|sztuczne źródło światła, zazwyczaj w kształcie walca, wykonane z paliwa stałego, wewnątrz którego, przez całą długość, umieszczony jest knot|element instalacji zapłonowej silnika
świergot|śpiew ptaków świergotanie ćwierkanie
świnia|zwierze parzystokopytne, wszystkożerne, o wydłużonym pysku, zakończonym ryjem i ciele pokrytym twardą szczeciną, występujące nieomal na całym świecie |świnia domowa - zwierzę hodowlane
święty|kanonizowany przez Kościół uznany przez Kościół za zbawionego i godnego kultu|cnotliwy, sprawiedliwy, bardzo dobry
żaba|płaz bezogonowy wodny lub lądowy
żagiel|ukształtowany płat tkaniny lub innego materiału, służący do napędzania jednostek żaglowych siłą wiatru
żaglówka|łódka wyposażona przynajmniej w jeden żagiel jacht
żartowniś|mężczyzna lubiący dowcipkować, robić żarty, kawały dowcipniś, kawalarz
żarówka|hermetycznie zamknięta szklana bańka, kulistego kształtu, w której umieszczony jest drucik rozżarzający się pod wpływem prądu elektrycznego i dający światło
żebra|kość tworząca szkielet klatki piersiowej u kręgowców|w architekturze: łuk poprzeczny wzmacniający sklepienie
żelazo|pierwiastek chemiczny o symbolu Fe
żona|określenie używane w stosunku do kobiety pozostającej w związku małżeńskim małżonka
żonglować|podrzucać i chwytać kolejno kilka przedmiotów|posługiwać się z dużą zręcznością jakimś przedmiotem
żołnierz|osoba, która pełni służbę wojskową w siłach zbrojnych danego kraju
żołądek|narząd będący najszerszą częścią przewodu pokarmowego, stanowiący miejsce częściowego trawienia pokarmu|żołądek mięśniowy - tylna część żołądka ptaków mielec
żołądź|(r. męski)|owoc dębu żołądź (r. żeński)|kolor w kartach, trefl żołądź (r. żeński)
żuć|gryźć coś powoli, rozgniatać zębami pokarm
żyrafa|roślinożerny ssak występujący w Afryce, zwierzę o charakterystycznej, długiej szyi i płowym umaszczeniu
żyła|naczynie krwionośne|masa skalna lub mineralna wypełniająca szczelinę w skałach
żółty|mający kolor dojrzałego owocu cytryny
żółw|przedstawiciel rzędu długowiecznych gadów o ciele otoczonym pancerzem pot. osoba powolna
żądło|aparat kłujący znajdujący się na odwłoku samic niektórych gatunków błonkówek
